,popularity,vote_average,vote_count,production_budget,worldwide_gross,profit,genre,genre_1,genre_2
0,6.099,3.3,102,1500000,0,-1500000,crime,drama,horror
1,17.892,6.9,4629,5000000,108286422,103286422,drama,horror,mystery
3,13.183,5.6,1312,35000000,71118378,36118378,action,drama,history
4,16.493,7.9,6631,20000000,181025343,161025343,biography,drama,history
5,11.435,7.0,4469,18000000,60217171,42217171,adventure,biography,drama
8,14.8,6.5,2368,61000000,132493015,71493015,action,comedy,crime
10,14.835999999999999,6.8,6527,42000000,202812429,160812429,action,comedy,crime
11,11.175999999999998,6.9,5167,50000000,331333876,281333876,action,comedy,crime
12,2.213,6.5,31,1000000,549185,-450815,drama,family,sport
13,1.8159999999999998,6.0,2,7200000,295492,-6904508,drama,mystery,romance
15,11.011,6.1,1279,28000000,38959900,10959900,action,drama,thriller
16,11.315,5.6,825,28000000,40966716,12966716,action,comedy,crime
18,23.68,6.0,3870,110000000,330780051,220780051,action,fantasy,war
20,11.28,7.0,1028,31000000,97470701,66470701,biography,drama,sport
21,25.049,6.0,2080,175000000,151716815,-23283185,action,adventure,drama
22,8.689,5.7,102,12000000,87793,-11912207,action,drama,war
30,10.352,6.3,1066,20000000,14807531,-5192469,biography,drama,romance
32,11.886,7.0,906,100000,2769782,2669782,drama,fantasy,romance
36,11.055,5.9,589,35000000,11846010,-23153990,comedy,drama,romance
37,7.87,6.3,333,12500000,1100287,-11399713,comedy,drama,fantasy
38,9.104,6.1,251,4000000,442550,-3557450,adventure,crime,thriller
40,11.128,7.1,1918,43000000,46414530,3414530,animation,drama,fantasy
41,12.270999999999999,6.6,792,20000000,8846875,-11153125,crime,drama,thriller
42,10.267000000000001,6.5,784,15000000,36068890,21068890,crime,drama,thriller
43,9.795,5.5,1408,35000000,117729621,82729621,crime,drama,horror
44,29.154,7.3,5848,17000000,334522294,317522294,drama,horror,sci-fi
45,21.121,6.6,1756,20000000,97628717,77628717,comedy,crime,drama
47,7.12,7.5,500,8000000,17382693,9382693,biography,comedy,drama
50,19.373,6.3,1685,28000000,62108587,34108587,action,crime,drama
51,6.935,5.9,402,8000000,37119358,29119358,adventure,biography,comedy
52,12.529000000000002,5.0,1073,103000000,133401882,30401882,adventure,family,fantasy
53,17.69,5.8,1791,35000000,86648359,51648359,action,mystery,thriller
55,14.133,7.9,3981,12000000,89309178,77309178,comedy,drama,fantasy
57,12.498,5.6,2009,67500000,137489730,69989730,action,fantasy,horror
60,10.6,6.6,186,20000000,46627836,26627836,drama,romance,thriller
61,12.197000000000001,6.3,583,12000000,82497035,70497035,action,adventure,drama
65,5.466,6.4,86,20000000,38585047,18585047,action,adventure,biography
66,8.065,5.5,385,13000000,18733666,5733666,comedy,drama,romance
68,8.058,5.2,29,750000,0,-750000,crime,drama,thriller
70,14.415,5.1,4154,130000000,251499665,121499665,action,adventure,drama
71,8.166,6.2,217,5000000,1075009,-3924991,crime,drama,romance
72,6.971,3.9,56,65000000,516279,-64483721,action,adventure,drama
73,2.877,3.9,31,1200000,0,-1200000,comedy,crime,horror
75,9.962,5.1,424,35000000,35426759,426759,action,crime,mystery
78,16.642,6.5,3803,170000000,276928112,106928112,adventure,family,fantasy
79,24.651,5.9,4971,97000000,238521247,141521247,horror,sci-fi,thriller
80,7.249,6.4,695,45000000,54876855,9876855,biography,drama,music
81,7.871,6.0,493,20000000,873617,-19126383,crime,drama,mystery
82,9.869,6.6,949,8500000,10386814,1886814,action,adventure,drama
86,19.611,6.7,2765,106000000,119266661,13266661,action,drama,romance
88,11.022,7.5,1339,60000000,47371191,-12628809,comedy,drama,family
90,9.685,5.3,1226,37000000,25387091,-11612909,comedy,drama,romance
91,24.535999999999998,5.9,1167,51000000,99624873,48624873,adventure,fantasy,mystery
92,12.672,5.5,1055,80000000,349088523,269088523,adventure,animation,comedy
93,14.972999999999999,5.8,852,90000000,249517956,159517956,adventure,animation,comedy
95,7.271,4.6,213,10000000,2341218,-7658782,action,crime,drama
96,6.56,5.0,93,1000000,26,-999974,action,comedy,drama
97,8.777999999999999,6.7,417,3500000,2611750,-888250,adventure,drama,romance
99,16.748,6.7,2188,50000000,135569212,85569212,action,biography,comedy
101,18.473,7.4,7658,58000000,547326372,489326372,action,biography,drama
102,9.97,6.0,1756,28000000,30295028,2295028,action,comedy,sci-fi
104,6.144,4.5,95,3000000,0,-3000000,drama,horror,mystery
107,8.235,5.9,264,18000000,17920013,-79987,comedy,drama,romance
108,0.6,5.0,1,300000,0,-300000,comedy,drama,romance
113,13.989,5.6,3357,6500000,256862920,250362920,horror,mystery,thriller
114,21.245,6.5,3141,15000000,305384865,290384865,horror,mystery,thriller
116,25.197,6.3,4465,55000000,43070915,-11929085,adventure,drama,horror
117,10.285,7.1,927,8000000,5706168,-2293832,animation,comedy,drama
118,8.113999999999999,6.4,434,27500000,15815509,-11684491,action,comedy,mystery
119,10.03,6.7,853,175000,2102779,1927779,drama,romance,sci-fi
122,32.715,7.1,11949,130000000,518858449,388858449,action,adventure,comedy
123,44.729,7.0,6290,130000000,623144660,493144660,action,adventure,comedy
124,2.061,7.2,41,1000000,288757,-711243,adventure,biography,documentary
126,6.33,5.8,152,3100000,123407,-2976593,horror,sci-fi,thriller
127,8.384,5.0,486,5000000,26517819,21517819,horror,mystery,sci-fi
128,38.102,6.8,6155,160000000,1146894640,986894640,action,adventure,fantasy
130,6.794,4.4,248,5000000,7556,-4992444,horror,sci-fi,thriller
131,15.793,7.2,5127,44500000,227140757,182640757,biography,drama,thriller
135,12.981,6.7,692,85000000,149717124,64717124,adventure,animation,comedy
136,10.613,6.2,1321,5000000,41824066,36824066,adventure,horror,mystery
139,10.579,6.2,666,50000000,83306268,33306268,action,adventure,comedy
140,21.662,6.3,3645,30000000,98345423,68345423,action,mystery,thriller
141,9.612,6.4,1144,13000000,6459183,-6540817,action,comedy,sci-fi
145,44.383,7.3,13457,330600000,1403013963,1072413963,action,adventure,sci-fi
146,80.773,8.3,13948,300000000,2048134200,1748134200,action,adventure,sci-fi
149,22.895,7.4,8034,34000000,228104185,194104185,action,crime,drama
151,13.292,6.3,78,8000000,343773,-7656227,drama,history,romance
155,31.32,6.8,1365,32000000,29204379,-2795621,crime,drama,mystery
159,7.122000000000001,7.9,232,13000000,121778347,108778347,action,comedy,drama
161,6.872000000000001,5.6,135,950000,78122,-871878,horror,sci-fi,thriller
165,5.141,6.0,37,3000000,0,-3000000,comedy,drama,romance
166,28.088,5.8,11991,250000000,867500281,617500281,action,adventure,fantasy
167,11.988,6.9,1045,25000000,18445379,-6554621,biography,comedy,drama
169,21.741999999999997,5.6,3240,220000000,313477717,93477717,action,adventure,sci-fi
170,14.429,6.1,4748,60000000,175863783,115863783,action,comedy,crime
171,10.136000000000001,6.1,1748,17000000,38028230,21028230,drama,fantasy,romance
172,7.53,6.9,605,1800000,23265132,21465132,adventure,drama,fantasy
173,0.879,8.0,1,9000000,3134509,-5865491,biography,drama,family
175,11.198,5.7,1826,50000000,60282876,10282876,drama,fantasy,romance
176,26.701,7.7,5730,160000000,1259199706,1099199706,family,fantasy,musical
177,14.584000000000001,7.0,2135,5000000,18945682,13945682,drama,fantasy,mystery
178,16.07,6.4,1098,22000000,19563579,-2436421,drama,horror,mystery
180,8.232999999999999,6.5,985,3000000,483938,-2516062,documentary,drama,news
182,10.322000000000001,6.9,532,3200000,14314407,11114407,comedy,drama,romance
187,10.11,5.6,1068,15000000,73259017,58259017,action,adventure,drama
189,6.067,7.0,66,9000000,3440939,-5559061,drama,history,war
191,7.518,6.6,503,6000000,10106975,4106975,biography,comedy,crime
192,7.331,5.9,150,1100000,56491,-1043509,horror,sci-fi,thriller
193,7.7170000000000005,7.0,238,7000000,14618727,7618727,drama,music,romance
196,36.92,7.8,10176,165000000,652127828,487127828,action,adventure,animation
197,6.76,6.6,250,40000000,25268680,-14731320,biography,drama,family
198,16.024,5.5,623,32000000,82332450,50332450,action,comedy,crime
199,2.707,6.8,54,30000000,648599,-29351401,action,adventure,animation
200,26.156,7.0,4777,19800000,0,-19800000,drama,horror,sci-fi
201,8.164,5.7,172,31000000,7220490,-23779510,action,biography,drama
202,5.489,6.2,42,21000000,606162,-20393838,drama,romance,war
204,14.645999999999999,6.4,2020,53000000,98837872,45837872,biography,crime,drama
205,1.7790000000000001,5.7,25,17500000,7285135,-10214865,drama,family,music
206,1.3659999999999999,5.9,5,7500000,32572,-7467428,action,crime,drama
207,8.05,6.8,193,9000000,21971021,12971021,action,drama,thriller
208,2.0580000000000003,5.1,11,200000000,1348258224,1148258224,action,adventure,sci-fi
211,16.824,5.3,1165,70000000,19665004,-50334996,action,crime,thriller
212,25.101,7.6,3138,15000000,93017335,78017335,biography,crime,drama
213,7.547999999999999,6.7,111,4500000,1217307,-3282693,action,adventure,western
214,48.571000000000005,7.4,6679,185000000,259357408,74357408,drama,mystery,sci-fi
215,9.772,5.0,1094,10000000,38985577,28985577,horror,mystery,thriller
216,8.258,6.9,405,16000000,6603926,-9396074,biography,drama,sport
222,12.003,6.1,268,26000000,2923959,-23076041,action,crime,drama
225,7.983,6.9,736,420000,437002,17002,crime,drama,thriller
227,1.881,6.6,10,14000000,20597806,6597806,biography,documentary,sport
228,37.196999999999996,8.1,7629,55000000,894985342,839985342,biography,drama,music
229,11.890999999999998,6.8,905,2000000,475846,-1524154,adventure,drama,horror
232,1.375,4.3,9,5000000,0,-5000000,action,drama,thriller
233,0.6,5.5,2,500000,1822,-498178,action,biography,documentary
236,5.972,6.4,18,1660000,80745,-1579255,horror,mystery,thriller
238,0.6,2.5,2,6000000,51411620,45411620,action,crime,drama
242,12.835999999999999,7.2,4313,40000000,162498338,122498338,drama,history,thriller
243,15.677,6.2,3181,90000000,0,-90000000,action,crime,fantasy
244,4.749,6.0,57,11000000,229653,-10770347,crime,drama,thriller
245,13.645999999999999,5.9,814,35000000,34480045,-519955,crime,drama,thriller
246,5.481,5.4,17,15000000,3471,-14996529,action,crime,drama
247,0.9159999999999999,6.0,1,11000000,62076141,51076141,drama,music,musical
248,1.636,6.7,15,12000000,450594,-11549406,comedy,drama,thriller
250,0.84,2.0,1,13000000,17856688,4856688,action,drama,war
252,17.574,5.4,681,55000000,22597969,-32402031,action,crime,thriller
254,43.078,6.5,2425,102000000,465195589,363195589,action,adventure,sci-fi
256,8.676,7.1,1195,55000000,90552675,35552675,drama,music,musical
265,17.604,6.9,450,10000000,11752387,1752387,biography,comedy,crime
266,39.137,7.4,14000,250000000,1140069413,890069413,action,adventure,sci-fi
267,25.808000000000003,6.9,12810,140000000,370569776,230569776,action,adventure,sci-fi
268,18.073,7.7,11034,170000000,714401889,544401889,action,adventure,sci-fi
269,15.482999999999999,7.6,3909,55000000,220648184,165648184,biography,drama,thriller
270,18.31,6.0,587,38000000,126577874,88577874,action,animation,comedy
272,0.6,5.5,4,4200000,313230,-3886770,drama,horror,sci-fi
276,23.498,5.9,4058,200000000,560155383,360155383,adventure,animation,comedy
277,18.427,6.7,2596,175000000,383541369,208541369,adventure,animation,comedy
279,9.432,6.1,149,12500000,2272186,-10227814,biography,comedy,crime
280,10.544,4.9,273,85000000,113026383,28026383,action,comedy,family
282,14.478,6.3,3133,50000000,217194805,167194805,action,comedy,crime
283,13.548,6.1,673,15000000,7885048,-7114952,action,adventure,drama
285,24.52,6.7,4995,49000000,105002056,56002056,action,crime,drama
286,9.454,6.9,1398,44000000,48478084,4478084,drama,fantasy,romance
287,6.546,7.0,329,20000000,8300821,-11699179,biography,drama,sport
288,6.406000000000001,6.4,216,100000,59424,-40576,comedy,crime,drama
289,0.6,1.0,1,1500000,0,-1500000,action,crime,thriller
291,14.658,5.0,842,1000000,42411721,41411721,horror,mystery,thriller
292,26.386,6.2,903,50000000,8004221,-41995779,crime,drama,history
293,13.744000000000002,6.0,657,25000000,23190292,-1809708,action,comedy,crime
294,8.807,5.9,940,13000000,11831131,-1168869,drama,music,romance
295,3.793,5.4,29,2500000,0,-2500000,comedy,drama,family
296,20.930999999999997,7.4,1280,75000000,197504758,122504758,adventure,animation,comedy
297,12.556,6.7,3084,12000000,123681790,111681790,drama,sci-fi,thriller
304,15.574000000000002,5.7,3714,125000000,493214888,368214888,action,adventure,fantasy
306,1.067,7.2,19,1500000,5396,-1494604,comedy,crime,drama
307,0.6,8.0,1,100000,0,-100000,comedy,drama,romance
308,14.681,6.8,4505,102000000,130673154,28673154,action,drama,mystery
309,18.335,6.4,1679,78000000,274392649,196392649,adventure,animation,comedy
311,4.408,4.2,36,8000000,0,-8000000,action,crime,thriller
315,10.584000000000001,6.5,1371,40000000,72295262,32295262,action,drama,thriller
318,1.9269999999999998,5.1,21,3000000,7445044,4445044,action,comedy,crime
319,6.93,6.4,340,270000,830700,560700,biography,crime,drama
320,17.046,5.2,1024,20000000,79114085,59114085,action,adventure,fantasy
321,12.809000000000001,7.1,1435,35000000,50363790,15363790,biography,drama,sport
323,10.444,6.3,2128,60000000,137551594,77551594,action,drama,thriller
324,12.357000000000001,6.2,1114,25000000,98406855,73406855,action,crime,drama
325,7.51,7.2,297,12500000,11826980,-673020,biography,crime,drama
327,8.82,5.4,796,37000000,55909910,18909910,action,comedy,crime
329,8.016,6.0,215,10000000,2179623,-7820377,drama,thriller,war
336,5.121,4.1,23,3000000,331000,-2669000,biography,crime,documentary
339,13.651,5.9,897,31500000,38771262,7271262,action,crime,drama
340,7.914,5.9,166,7000000,386744,-6613256,crime,drama,thriller
341,9.897,6.5,2986,55000000,74966854,19966854,drama,fantasy,horror
343,1.755,4.9,18,1200000,0,-1200000,horror,mystery,thriller
346,7.735,6.0,201,7000000,10062896,3062896,comedy,drama,romance
347,2.6069999999999998,4.6,33,1250000,0,-1250000,comedy,romance,thriller
349,6.625,5.5,103,3000000,1324299,-1675701,comedy,drama,romance
350,10.022,8.1,358,9500000,294654618,285154618,action,biography,drama
351,3.035,6.2,22,14000000,34700000,20700000,drama,mystery,romance
352,8.933,6.7,260,10000000,8465845,-1534155,biography,comedy,drama
353,15.75,5.9,4197,150000000,238202668,88202668,comedy,fantasy,horror
354,11.582,6.1,1004,3500000,27704111,24204111,horror,sci-fi,thriller
355,15.331,7.3,2715,30000000,150807172,120807172,biography,drama,history
356,4.656000000000001,5.0,46,12000000,1200346,-10799654,comedy,drama,romance
357,12.498,6.0,1743,55000000,152269033,97269033,comedy,crime,romance
358,1.4,2.0,1,75000,8799,-66201,drama,sci-fi,thriller
359,27.641,7.3,7080,170000000,710644566,540644566,action,adventure,drama
361,1.4,4.2,3,80000000,158908290,78908290,crime,horror,thriller
362,10.349,6.0,866,30000000,19599974,-10400026,action,crime,drama
363,9.491,5.9,357,6000000,1673635,-4326365,crime,drama,thriller
365,35.067,7.6,20175,58000000,801025593,743025593,action,adventure,comedy
366,38.894,7.5,8773,110000000,786680557,676680557,action,adventure,comedy
367,12.048,6.8,2676,25000000,142033509,117033509,drama,romance,war
368,7.455,6.1,296,1250000,5403771,4153771,comedy,drama,romance
370,18.014,5.9,1207,30000000,48575965,18575965,action,crime,drama
372,13.685,6.7,2606,156000000,122603824,-33396176,action,drama,history
373,11.283,6.1,1104,30000000,87956618,57956618,horror,mystery,thriller
376,22.738000000000003,6.6,1244,30000000,80131391,50131391,action,crime,drama
380,1.508,6.9,33,4000000,596335,-3403665,biography,drama,music
381,23.673000000000002,7.2,10057,69000000,543464573,474464573,animation,comedy,family
382,19.014,6.9,7319,76000000,975216835,899216835,adventure,animation,comedy
383,16.407,6.3,4106,75000000,1034727750,959727750,adventure,animation,comedy
384,17.815,5.9,176,9000000,3681096,-5318904,action,crime,drama
386,4.268,5.0,50,500000,1778,-498222,action,adventure,comedy
388,5.893,4.5,303,7000000,36146087,29146087,horror,mystery,thriller
392,12.255999999999998,6.0,736,15000000,76954311,61954311,comedy,drama,family
398,16.982,6.9,8279,85000000,276014965,191014965,action,adventure,mystery
402,33.035,7.3,12582,165000000,676404566,511404566,action,adventure,fantasy
405,7.254,5.8,302,7000000,1857458,-5142542,comedy,crime,drama
406,12.78,5.9,2709,5500000,41268579,35768579,comedy,drama,romance
407,8.405,5.5,550,25000000,39126427,14126427,fantasy,horror,thriller
408,9.246,7.2,954,7000000,18190831,11190831,comedy,crime,drama
411,29.043000000000003,6.2,3719,70000000,220241723,150241723,action,drama,fantasy
413,6.867999999999999,7.4,721,8500000,122747755,114247755,action,adventure,animation
414,0.664,3.0,2,60000000,30063805,-29936195,action,adventure,sci-fi
416,9.047,6.0,670,50000000,41642166,-8357834,drama,mystery,thriller
417,1.4,5.2,5,68000000,75685268,7685268,crime,documentary,drama
418,13.222999999999999,6.7,2788,45000000,41467606,-3532394,action,crime,sci-fi
419,8.997,6.0,528,500000,407100,-92900,comedy,drama,romance
421,14.095999999999998,5.3,959,50000000,41042583,-8957417,action,fantasy,thriller
422,6.957000000000001,4.0,94,12000000,0,-12000000,action,comedy,crime
428,1.4909999999999999,5.4,16,5200000,11633427,6433427,action,crime,drama
430,24.358,7.4,9156,150000000,499837368,349837368,action,drama,history
433,7.507999999999999,4.4,243,20000000,6093725,-13906275,action,comedy,crime
435,16.675,5.9,338,50000000,45285890,-4714110,adventure,animation,comedy
436,7.189,5.7,377,13000000,42174545,29174545,adventure,family,sci-fi
437,14.69,6.8,4168,8000000,76200721,68200721,comedy,drama,romance
439,0.907,4.5,2,100000,0,-100000,action,drama,sci-fi
440,11.482999999999999,7.2,1190,23000000,45060480,22060480,biography,comedy,drama
443,11.252,6.3,794,60000000,82812456,22812456,crime,drama,mystery
448,6.2410000000000005,6.2,48,10000000,197901,-9802099,comedy,drama,romance
452,13.152000000000001,7.3,1770,15000000,57586606,42586606,action,crime,drama
453,15.533,6.6,3558,110000000,127983283,17983283,action,adventure,fantasy
456,8.722000000000001,6.7,464,8000000,25621449,17621449,comedy,drama,romance
457,6.899,6.7,83,500000,0,-500000,mystery,sci-fi,thriller
460,13.995,6.4,1670,100000000,262794441,162794441,adventure,animation,family
461,9.227,5.8,459,40000000,74156610,34156610,adventure,animation,comedy
462,5.742999999999999,4.8,117,650000,171962,-478038,drama,fantasy,horror
463,17.88,6.7,2799,70000000,103735965,33735965,action,crime,mystery
464,15.924000000000001,6.3,476,17000000,3917679,-13082321,crime,drama,history
465,19.9,6.7,2874,65000000,221297061,156297061,action,adventure,biography
469,13.089,6.4,2664,17000000,97778356,80778356,fantasy,horror,thriller
470,4.208,6.3,73,80000000,98341932,18341932,drama,mystery,sci-fi
471,18.485,7.6,8026,13000000,38358392,25358392,drama,mystery,sci-fi
472,5.934,4.7,121,25000,489792,464792,horror,mystery,thriller
473,26.789,5.7,2909,140000000,268314513,128314513,action,adventure,drama
475,10.219,7.1,850,13000000,35402802,22402802,drama,thriller,war
477,11.624,6.6,384,50000000,26097497,-23902503,biography,drama,thriller
478,0.6,4.2,3,550000,9111,-540889,biography,documentary,drama
480,28.563000000000002,7.4,12152,180000000,802402853,622402853,adventure,family,fantasy
481,48.508,6.9,4870,200000000,652220086,452220086,adventure,family,fantasy
482,16.36,4.4,3837,87500000,333132750,245632750,action,adventure,drama
483,2.097,7.2,4294,125000000,630163454,505163454,action,crime,thriller
484,14.172,6.2,895,24000000,35792945,11792945,action,crime,drama
486,12.45,5.8,277,25000000,21038441,-3961559,adventure,comedy,drama
491,19.479,7.1,1425,111000000,289847930,178847930,adventure,animation,comedy
493,22.511999999999997,6.1,3535,55000000,371350619,316350619,drama,romance,thriller
495,21.229,5.4,6451,40000000,570998101,530998101,drama,romance,thriller
496,0.6,5.2,3,500000,0,-500000,action,romance,sport
500,15.392999999999999,7.0,7845,200000000,1021215193,821215193,adventure,animation,comedy
502,12.943,6.9,446,3500000,3874772,374772,drama,mystery,thriller
504,9.844,5.7,1249,26000000,61308153,35308153,drama,horror,mystery
506,9.781,7.4,859,14000000,4289993,-9710007,comedy,drama,romance
507,8.453,6.7,849,29000000,56000339,27000339,biography,comedy,drama
508,10.704,6.8,4173,65000000,168065700,103065700,comedy,crime,drama
509,4.705,2.1,46,45000000,73706,-44926294,action,animation,comedy
510,10.269,6.6,929,24000000,62989834,38989834,comedy,drama,music
512,4.519,6.6,63,12000000,10026255,-1973745,drama,history,war
514,15.953,7.4,406,3500000,16376066,12876066,drama,music,romance
516,0.669,6.3,2,3000000,78948,-2921052,drama,history,war
517,4.738,5.4,21,12000000,46730578,34730578,documentary,drama,news
518,9.968,7.0,621,3750000,2436111,-1313889,comedy,crime,drama
519,9.42,7.4,624,3000000,11262769,8262769,comedy,drama,romance
520,3.989,5.8,51,45000000,112006296,67006296,horror,sci-fi,thriller
521,14.627,6.8,1685,39000000,81150788,42150788,animation,comedy,family
523,9.31,5.8,231,33000000,70958,-32929042,comedy,horror,sci-fi
524,4.476,5.1,28,6000000,0,-6000000,comedy,crime,thriller
525,11.062000000000001,5.8,410,55000000,110387072,55387072,adventure,animation,comedy
526,12.116,6.3,540,10000000,3793739,-6206261,action,comedy,crime
527,8.574,6.6,787,50000000,23237252,-26762748,action,biography,drama
528,7.313,7.3,360,7000000,1732228,-5267772,biography,drama,romance
534,12.862,6.2,1075,52000000,53139168,1139168,action,crime,thriller
535,9.722999999999999,6.3,80,2300000,59696,-2240304,crime,drama,family
536,9.677999999999999,5.8,987,150000000,1272469910,1122469910,adventure,drama,sport
537,9.587,7.4,645,900000,17549645,16649645,biography,drama,romance
539,20.396,7.3,6538,190000000,1518722794,1328722794,action,crime,thriller
541,29.116999999999997,7.4,6653,80000000,210315681,130315681,action,drama,war
542,15.065,5.5,3883,140000000,375740705,235740705,action,adventure,sci-fi
543,19.459,6.9,2756,37000000,117378084,80378084,action,comedy,crime
544,13.029000000000002,6.3,2527,60000000,104100903,44100903,action,crime,drama
546,13.652999999999999,5.8,2246,100000000,220796009,120796009,action,sci-fi,thriller
548,8.485,5.9,980,40000000,91455875,51455875,adventure,comedy,music
549,6.287999999999999,6.7,251,30000000,33339868,3339868,biography,drama,music
550,0.8340000000000001,5.5,8,5000000,255367951,250367951,horror,mystery,thriller
553,21.308000000000003,6.0,5128,110000000,167910690,57910690,action,drama,sci-fi
554,18.678,4.8,2039,57000000,149217355,92217355,action,fantasy,thriller
555,16.079,5.4,3780,30000000,295212467,265212467,action,comedy,fantasy
560,5.925,6.5,83,30000000,4967493,-25032507,comedy,drama,romance
562,18.517,5.4,2353,140000000,138836756,-1163244,action,adventure,fantasy
563,24.982,6.1,5053,160000000,529076069,369076069,action,adventure,sci-fi
566,31.215,7.9,10459,61000000,368567189,307567189,drama,mystery,thriller
567,1.179,5.1,7,10000000,0,-10000000,drama,romance,thriller
568,18.957,6.2,2147,58000000,158905324,100905324,adventure,comedy,family
569,20.238,5.6,428,35000000,93291478,58291478,adventure,comedy,family
570,10.033999999999999,5.2,231,10000000,6089100,-3910900,biography,crime,drama
571,7.117000000000001,6.1,202,5300000,440821,-4859179,comedy,horror,sci-fi
572,1.547,10.0,1,5000000,8297,-4991703,comedy,crime,romance
573,6.058,6.0,352,30000000,25199891,-4800109,biography,drama,romance
577,27.836,7.2,9586,110000000,693698673,583698673,drama,sci-fi,thriller
578,1.891,7.3,37,9000000,2000093,-6999907,biography,family,sport
579,36.284,8.3,3499,23000000,322034439,299034439,biography,comedy,drama
580,17.257,5.1,4290,200000000,219535492,19535492,action,adventure,sci-fi
581,9.943,6.8,1314,5000000,3807503,-1192497,horror,music,thriller
582,11.519,6.4,1176,100000000,97523020,-2476980,action,drama,thriller
583,3.5189999999999997,6.0,44,2900000,25935,-2874065,comedy,drama,romance
584,1.9809999999999999,7.0,16,2000000,35312,-1964688,comedy,drama,family
587,7.917999999999999,6.0,711,40000000,69807260,29807260,comedy,drama,sport
588,49.606,7.9,17958,170000000,770867516,600867516,action,adventure,comedy
589,10.767999999999999,5.1,1282,112000000,232017848,120017848,adventure,comedy,family
590,9.329,4.8,68,10000000,1638202,-8361798,action,adventure,comedy
591,2.157,6.3,8,200000,0,-200000,drama,sci-fi,thriller
592,24.074,8.1,6608,40000000,168904682,128904682,biography,drama,history
593,12.312000000000001,5.9,2328,22000000,64160680,42160680,comedy,drama,music
596,8.17,6.1,167,20000000,5031975,-14968025,action,biography,drama
597,9.709,6.6,1944,30000000,65343694,35343694,action,drama,thriller
598,15.982000000000001,5.9,4548,50000000,214949716,164949716,action,fantasy,horror
599,0.6,7.0,3,3000000,5746453,2746453,documentary,drama,family
602,21.23,6.6,3211,5000000,125010260,120010260,horror,mystery,thriller
603,8.131,5.9,754,135000000,157956466,22956466,adventure,animation,comedy
604,2.309,6.7,25,250000,67665,-182335,documentary,drama,sport
605,10.459000000000001,6.2,1294,2000000,17187434,15187434,action,adventure,sci-fi
607,2.9139999999999997,4.6,10,60000,0,-60000,crime,drama,horror
608,10.015,5.6,747,23000000,36374700,13374700,action,drama,thriller
609,13.200999999999999,7.4,87,2000000,2420962,420962,comedy,drama,music
610,9.718,6.2,363,12000000,100916299,88916299,biography,drama,family
611,0.6,5.0,1,35000000,28906817,-6093183,action,crime,thriller
612,3.01,6.4,46,1000000,552614,-447386,crime,drama,romance
614,15.749,7.3,2468,12000000,37584304,25584304,action,crime,drama
615,7.8020000000000005,6.4,265,1000000,14662703,13662703,comedy,drama,romance
617,15.968,7.9,7776,23000000,48163815,25163815,drama,romance,sci-fi
619,23.921999999999997,5.6,2606,70000000,250700000,180700000,action,adventure,fantasy
620,10.265,6.0,812,42000000,73239258,31239258,action,comedy,sport
621,7.886,5.9,848,50000000,108660270,58660270,drama,fantasy,romance
622,26.185,7.0,2491,10000000,70133905,60133905,drama,horror,mystery
623,1.4,6.7,12,42000000,66787173,24787173,action,drama,thriller
624,7.14,7.0,335,7000000,382946,-6617054,comedy,crime,drama
626,14.751,8.0,4710,25000000,231771716,206771716,biography,drama,history
631,7.544,4.9,43,500000,528,-499472,action,sci-fi,thriller
634,14.082,5.6,1764,35000000,82182803,47182803,action,adventure,crime
636,8.844,5.9,300,3000000,834953,-2165047,action,comedy,horror
637,19.331,4.1,217,42000000,41926605,-73395,adventure,comedy,crime
642,3.843,6.3,33,1200000,2859955,1659955,drama,family,sport
645,14.738,5.6,611,63000000,188657593,125657593,adventure,animation,comedy
646,8.312999999999999,6.1,429,30000000,133085295,103085295,comedy,drama,romance
651,9.607000000000001,5.6,1000,35000000,45671512,10671512,action,comedy,crime
653,8.052999999999999,5.1,512,14000000,12826644,-1173356,comedy,mystery,sci-fi
654,14.585,5.9,471,15000000,12758799,-2241201,action,drama,sci-fi
655,15.318,6.9,5013,85000000,378505812,293505812,animation,comedy,family
656,16.553,6.7,3184,80000000,469500298,389500298,animation,comedy,family
657,26.815,6.8,1673,65000000,527079962,462079962,adventure,animation,comedy
659,8.72,5.8,1033,6900000,44103982,37203982,drama,horror,thriller
660,8.455,6.6,505,1500000,236863,-1263137,comedy,horror,mystery
662,10.270999999999999,6.1,2036,37000000,100003780,63003780,comedy,drama,romance
663,28.734,7.7,7610,165000000,494870992,329870992,action,adventure,animation
664,27.105999999999998,7.7,5589,145000000,614586270,469586270,action,adventure,animation
666,12.545,7.8,915,2500000,23845533,21345533,adventure,comedy,drama
669,11.555,6.0,2805,50000000,146195159,96195159,action,adventure,sci-fi
670,9.558,4.9,296,18000000,309608,-17690392,action,crime,drama
671,9.7,7.6,155,7000000,85604221,78604221,biography,drama,family
674,8.459,7.6,1814,1000000,852399,-147601,drama,romance,sci-fi
677,12.7,5.2,1090,65000000,74575290,9575290,action,fantasy,horror
678,15.407,7.5,2904,11000000,53797409,42797409,biography,comedy,drama
679,5.002,5.2,42,6000000,0,-6000000,documentary,sport,thriller
680,18.233,5.9,2430,105000000,402156682,297156682,adventure,animation,comedy
681,17.537,6.3,4598,95000000,879765137,784765137,adventure,animation,comedy
684,13.552999999999999,5.8,2230,35000000,175361578,140361578,adventure,comedy,crime
686,12.047,7.4,2703,11000000,78356170,67356170,drama,fantasy,music
687,14.774000000000001,5.8,1431,75000000,211562435,136562435,action,drama,fantasy
689,14.33,6.6,2137,100000000,89693309,-10306691,action,adventure,biography
690,5.099,6.1,83,13000000,509193,-12490807,drama,romance,war
691,18.912,6.8,6245,35000000,165103952,130103952,action,crime,drama
693,8.972999999999999,8.1,1034,6800000,16038343,9238343,drama,mystery,war
694,27.92,8.3,22186,160000000,835524642,675524642,action,adventure,sci-fi
695,36.286,7.6,6354,200000000,1242520711,1042520711,action,adventure,animation
696,15.732000000000001,5.1,3911,165000000,384169424,219169424,action,adventure,sci-fi
697,3.562,4.2,35,1800000,0,-1800000,action,adventure,sci-fi
700,6.122000000000001,5.2,27,4000000,4327,-3995673,action,drama,mystery
701,2.168,2.4,8,2100000,0,-2100000,action,horror,sci-fi
703,14.244000000000002,6.6,1359,20000000,14772346,-5227654,comedy,crime,drama
707,16.197,6.9,3582,1500000,99870886,98370886,horror,mystery,thriller
708,16.017,6.1,1306,10000000,167885588,157885588,horror,mystery,thriller
711,28.44,8.2,18597,165000000,666379375,501379375,adventure,drama,sci-fi
712,7.132999999999999,5.3,121,10000000,0,-10000000,action,adventure,drama
715,5.445,7.6,71,5500000,5580479,80479,biography,documentary,history
716,28.515,6.8,12368,170000000,621156389,451156389,action,adventure,sci-fi
717,32.093,6.9,14155,200000000,1215392272,1015392272,action,adventure,sci-fi
718,10.202,6.1,373,25000000,5297411,-19702589,action,adventure,drama
722,1.3319999999999999,4.6,12,10000000,1642939,-8357061,comedy,drama,fantasy
723,10.01,7.0,1324,8000000,6632950,-1367050,comedy,drama,romance
724,8.628,6.2,1303,35000000,84606030,49606030,biography,crime,drama
727,18.312,6.4,4155,60000000,217370736,157370736,action,crime,thriller
729,11.061,6.1,1687,60000000,131377412,71377412,action,drama,thriller
731,10.715,6.3,655,20000000,171685793,151685793,action,comedy,documentary
732,8.818999999999999,6.4,1420,9000000,36588512,27588512,biography,drama,history
734,8.825,5.5,439,25000000,3771345,-21228655,action,drama,western
737,7.942,5.4,241,5000000,2368937,-2631063,adventure,drama,family
738,6.933,6.9,380,40000000,65282732,25282732,biography,drama,music
739,17.398,6.1,1887,10000000,102445196,92445196,crime,horror,mystery
740,6.461,5.5,96,5000000,927074,-4072926,biography,drama,music
743,18.549,6.1,3338,275000000,282778100,7778100,action,adventure,sci-fi
744,78.123,7.2,10081,30000000,76235001,46235001,action,crime,thriller
745,15.542,6.1,1810,45000000,164640401,119640401,action,adventure,comedy
746,13.467,4.6,708,47000000,11022696,-35977304,action,drama,fantasy
747,14.454,5.9,2152,79000000,318146162,239146162,action,adventure,comedy
749,6.787000000000001,6.4,70,27500000,31157914,3657914,comedy,drama,music
751,20.395,6.7,7213,90000000,964496193,874496193,action,adventure,comedy
753,24.058000000000003,5.3,4401,179000000,181982519,2982519,action,adventure,sci-fi
754,20.709,6.6,14056,215000000,1648854864,1433854864,action,adventure,sci-fi
755,34.958,6.5,5995,170000000,1305772799,1135772799,action,adventure,sci-fi
758,7.047000000000001,6.2,211,12000000,21867665,9867665,comedy,romance,sport
759,34.953,6.2,7510,300000000,655945209,355945209,action,adventure,fantasy
762,8.952,6.0,644,15000000,20688141,5688141,action,comedy,crime
767,9.597000000000001,5.6,129,15000000,20898221,5898221,adventure,animation,family
769,14.793,6.4,3785,28000000,63129909,35129909,action,comedy,crime
772,7.0360000000000005,6.1,332,800000,462206,-337794,crime,drama,horror
774,10.062000000000001,6.6,507,5000000,6656705,1656705,biography,crime,drama
775,15.135,6.2,1093,70000000,65409046,-4590954,action,crime,thriller
776,13.742,6.5,703,10000000,4659110,-5340890,crime,drama,thriller
777,10.221,5.8,1314,75000000,95572749,20572749,action,comedy,romance
779,23.805,6.2,289,30000000,10096821,-19903179,action,drama,sci-fi
780,21.793000000000003,6.5,3305,175000000,139630336,-35369664,action,adventure,drama
782,24.337,7.0,5531,104000000,408803696,304803696,action,adventure,comedy
783,26.103,7.6,10287,94000000,404561724,310561724,action,adventure,comedy
784,6.058,5.8,67,9200000,17155193,7955193,action,drama,romance
785,17.713,6.0,2494,117000000,258751370,141751370,action,adventure,comedy
787,29.388,6.3,6054,185000000,561072059,376072059,action,adventure,fantasy
788,9.417,6.0,1046,15000000,61788393,46788393,comedy,fantasy,horror
790,13.847000000000001,7.7,2029,55000000,77548122,22548122,action,adventure,animation
791,17.363,6.7,3628,150000000,664837547,514837547,action,adventure,animation
792,16.248,6.7,2944,140000000,517599142,377599142,action,adventure,animation
794,16.275,7.9,10028,20000000,426351163,406351163,comedy,drama,music
797,7.261,5.8,676,30000000,61449135,31449135,comedy,drama,romance
800,12.147,7.0,1660,26000000,54393687,28393687,action,adventure,documentary
801,6.303999999999999,6.6,65,20000000,2507181,-17492819,biography,drama,history
805,13.897,4.0,713,18500000,4221341,-14278659,horror,mystery,thriller
806,10.195,6.8,1692,25000000,42425450,17425450,biography,crime,drama
807,10.754000000000001,6.6,1223,100000000,139716717,39716717,action,adventure,animation
808,1.6269999999999998,7.5,4,26000000,67647574,41647574,action,fantasy,horror
809,0.675,7.0,2,20000000,28270399,8270399,drama,fantasy,horror
813,9.394,6.9,1706,30000000,82148538,52148538,adventure,comedy,drama
816,15.0,7.3,8723,120000000,620912003,500912003,adventure,drama,fantasy
822,12.693,6.8,2261,65000000,273346281,208346281,biography,drama,history
823,17.215999999999998,8.1,3833,12000000,149570720,137570720,comedy,drama,romance
824,5.805,7.0,292,20000000,17769299,-2230701,drama,history,war
827,11.322000000000001,6.2,759,65000000,21774432,-43225568,action,crime,drama
830,11.273,5.9,1004,20000000,33943049,13943049,action,sci-fi,thriller
831,45.0,7.8,12330,127000000,615461394,488461394,action,drama,sci-fi
832,15.743,6.7,1627,29000000,44264271,15264271,comedy,crime,drama
833,12.43,6.1,1810,11000000,10431506,-568494,comedy,drama,romance
834,8.557,5.3,59,8000000,433732,-7566268,crime,mystery,thriller
836,15.404000000000002,7.4,2289,40000000,149804632,109804632,action,biography,drama
838,16.779,6.8,6723,30000000,170466405,140466405,action,crime,drama
839,7.029,5.8,352,2000000,2009644,9644,drama,fantasy,mystery
842,6.185,6.1,28,25000000,146149,-24853851,biography,comedy,drama
843,8.261000000000001,5.8,384,18000000,42227490,24227490,comedy,fantasy,romance
844,15.607999999999999,8.2,3165,10000000,65520633,55520633,comedy,drama,romance
846,8.506,6.7,529,9000000,12898064,3898064,biography,drama,romance
847,1.4,6.0,4,916000,6188421,5272421,adventure,crime,drama
849,16.73,6.3,10019,40000000,457507776,417507776,action,sci-fi,thriller
850,7.666,5.3,270,10000000,8629895,-1370105,action,comedy,romance
851,12.557,6.3,1862,12500000,46370970,33870970,action,crime,thriller
852,10.36,5.5,1079,20000000,18273009,-1726991,action,crime,sci-fi
853,9.12,6.5,477,30000000,3721988,-26278012,action,biography,crime
854,28.099,7.4,14454,150000000,370098020,220098020,action,adventure,sci-fi
855,18.705,6.5,3380,145000000,746921271,601921271,adventure,animation,comedy
856,7.275,6.6,150,8000000,15644196,7644196,biography,comedy,drama
860,8.681000000000001,6.2,1110,14500000,123660597,109160597,comedy,drama,music
861,19.274,7.0,8143,180000000,758536735,578536735,action,adventure,family
863,27.666999999999998,6.5,9758,225000000,667999518,442999518,action,adventure,sci-fi
864,11.263,6.3,1460,42000000,49621440,7621440,action,adventure,crime
866,8.262,6.9,319,35000000,29890402,-5109598,biography,drama,history
867,16.24,6.2,618,6000000,1427656,-4572344,action,fantasy,horror
869,6.666,6.0,471,350000,10000000,9650000,action,horror,thriller
873,8.852,5.7,299,150000000,39549758,-110450242,adventure,animation,family
874,7.879,7.3,257,12000000,10116816,-1883184,biography,crime,drama
875,9.477,6.7,413,1000000,5438911,4438911,drama,mystery,thriller
876,30.419,6.6,1457,130000000,341528518,211528518,comedy,family,fantasy
877,16.115,6.6,592,25000000,46734733,21734733,biography,drama,history
878,7.766,6.8,407,20000000,43658157,23658157,biography,comedy,documentary
879,8.88,5.2,383,10000000,4563080,-5436920,action,adventure,family
880,17.31,6.6,6365,61000000,310566162,249566162,action,sci-fi,thriller
881,8.197000000000001,7.3,358,17000000,45707924,28707924,biography,drama,sport
882,8.677,7.6,1570,8000000,9266180,1266180,comedy,drama,romance
884,16.302,5.6,1929,40000000,109738840,69738840,action,adventure,thriller
888,22.855,6.8,3635,130000000,321887208,191887208,action,animation,comedy
890,26.176,6.4,6398,215000000,654213485,439213485,action,adventure,comedy
893,13.171,7.5,3965,30000000,162502774,132502774,comedy,documentary,drama
894,8.652999999999999,6.3,1105,18000000,7680250,-10319750,action,drama,mystery
895,11.675999999999998,6.0,1552,33000000,75898100,42898100,adventure,comedy,romance
896,21.246,6.0,920,35000000,66295121,31295121,action,adventure,thriller
898,7.771,6.8,353,25000000,39217912,14217912,biography,drama,sport
899,9.338,6.4,7343,74000000,1160336173,1086336173,adventure,animation,comedy
900,10.078,7.1,478,13000000,73798736,60798736,biography,drama,family
901,13.220999999999998,5.8,2099,85000000,173613482,88613482,adventure,comedy,drama
902,7.2989999999999995,5.5,301,11000000,2352511,-8647489,crime,drama,mystery
903,10.128,6.3,50,15000000,15362298,362298,action,crime,drama
906,1.96,6.5,16,150000000,637517365,487517365,adventure,animation,comedy
909,11.134,6.4,1859,27000000,93466095,66466095,crime,drama,thriller
910,15.392999999999999,7.1,2255,50000000,111300835,61300835,biography,drama,sport
911,0.6,5.0,1,5000000,64240813,59240813,action,drama,thriller
912,8.827,5.9,414,125000000,61642798,-63357202,action,adventure,comedy
914,20.33,7.0,6362,200000000,743588329,543588329,adventure,animation,comedy
915,11.017000000000001,6.2,1193,20000000,39686769,19686769,adventure,comedy,family
917,14.085999999999999,7.7,3023,16000000,68848446,52848446,adventure,comedy,drama
919,9.912,5.7,843,8000000,7298786,-701214,action,horror,sci-fi
920,10.595,6.3,717,40000000,59795070,19795070,comedy,drama,romance
921,40.095,6.0,1751,100000000,85287417,-14712583,action,adventure,fantasy
922,13.263,5.4,1666,60000000,30396134,-29603866,action,comedy,crime
923,15.227,7.0,3458,30000000,42531076,12531076,drama,horror,mystery
925,12.812999999999999,6.6,1357,145000000,269806430,124806430,adventure,animation,comedy
926,7.8839999999999995,6.5,301,14000000,25187026,11187026,biography,drama,history
929,9.118,6.2,473,55000000,79312301,24312301,adventure,comedy,crime
930,15.937000000000001,6.7,5406,55000000,345922730,290922730,crime,drama,mystery
935,2.0069999999999997,5.8,5,1000000,0,-1000000,comedy,drama,romance
937,9.808,5.4,247,25000000,16727470,-8272530,horror,mystery,thriller
939,1.1320000000000001,4.8,6,1600000,2595644,995644,crime,drama,thriller
940,9.521,7.4,967,12000000,24761360,12761360,adventure,comedy,drama
941,13.722999999999999,6.1,2389,66000000,194169619,128169619,action,crime,thriller
944,14.508,7.1,4590,20000000,70652284,50652284,drama,mystery,thriller
947,20.064,6.1,3536,127000000,353756621,226756621,adventure,comedy,family
950,25.596999999999998,7.7,5860,8500000,50334418,41834418,crime,drama,thriller
952,8.882,5.1,125,2000000,0,-2000000,crime,drama,horror
954,14.519,5.8,286,13200000,54323210,41123210,action,crime,drama
959,2.2640000000000002,5.6,23,50000000,222383055,172383055,action,mystery,thriller
960,9.325,4.2,192,18000000,30535660,12535660,adventure,animation,comedy
961,2.246,4.2,50,800000,35688,-764312,comedy,drama,romance
965,16.646,7.4,9871,75000000,342769200,267769200,crime,mystery,thriller
966,25.805,6.8,6744,90000000,328325007,238325007,action,adventure,comedy
967,18.534000000000002,6.5,6850,120000000,287916633,167916633,action,adventure,sci-fi
968,8.232000000000001,6.7,256,1000000,3324070,2324070,comedy,drama,romance
972,11.378,5.9,1032,3000000,6239723,3239723,action,drama,mystery
978,8.62,5.5,615,42000000,36197221,-5802779,action,comedy,crime
980,14.163,7.0,603,38000000,24555177,-13444823,action,biography,drama
981,3.2710000000000004,5.1,20,3000000,47469,-2952531,action,drama,thriller
983,15.389000000000001,5.1,1670,5000000,103300632,98300632,horror,mystery,thriller
984,11.823,6.0,1416,9000000,81831866,72831866,drama,horror,mystery
990,9.139,6.6,1077,22000000,15434375,-6565625,crime,drama,thriller
992,13.377,5.8,4829,200000000,490359051,290359051,adventure,family,fantasy
993,16.759,6.8,7632,190000000,411002906,221002906,action,adventure,sci-fi
994,30.019000000000002,5.9,2213,155000000,290930148,135930148,action,adventure,sci-fi
995,13.565,7.0,1904,55000000,258789097,203789097,adventure,comedy,family
996,16.509,6.1,2500,26000000,81275291,55275291,action,comedy,crime
998,13.054,5.9,1701,150000000,151525973,1525973,adventure,comedy,family
999,11.564,6.0,3587,12000000,85450484,73450484,comedy,drama,mystery
1002,9.669,5.9,1197,5000000,207039844,202039844,horror,mystery,thriller
1003,8.965,5.4,1026,5000000,142817992,137817992,horror,mystery,thriller
1004,8.157,5.2,774,10000000,77959374,67959374,horror,mystery,thriller
1005,9.446,5.3,752,5000000,90904854,85904854,horror,mystery,thriller
1006,13.32,6.8,1358,60000000,108119662,48119662,adventure,animation,comedy
1008,14.95,5.8,1868,35000000,48543388,13543388,action,crime,thriller
1009,6.056,6.1,206,10000000,1616353,-8383647,drama,history,mystery
1010,14.074000000000002,6.8,7869,110000000,302239672,192239672,drama,romance,sci-fi
1011,9.486,7.1,736,5000000,10727536,5727536,comedy,drama,romance
1012,15.435,6.9,1337,40000000,52837989,12837989,action,crime,drama
1014,15.234000000000002,6.5,3017,40000000,101162106,61162106,adventure,comedy,sci-fi
1015,15.940999999999999,5.0,900,38000000,107650646,69650646,action,comedy,crime
1016,12.005,7.1,98,5000000,25529498,20529498,adventure,biography,drama
1017,0.84,5.0,1,50000000,161626121,111626121,action,comedy,crime
1019,20.899,6.4,2273,132000000,366942531,234942531,adventure,animation,comedy
1021,32.476,6.5,716,25000000,51800758,26800758,action,crime,drama
1022,26.691,6.1,4229,95000000,223050874,128050874,adventure,family,fantasy
1023,15.762,5.9,3109,90000000,200859554,110859554,adventure,family,fantasy
1025,15.974,6.5,650,50000000,347136477,297136477,adventure,animation,comedy
1027,8.978,7.4,945,12000000,98963392,86963392,biography,comedy,drama
1030,28.101,6.6,6931,230000000,788241137,558241137,action,adventure,fantasy
1031,30.579,6.4,8571,410600000,1045663875,635063875,action,adventure,fantasy
1032,13.886,7.3,4233,17000000,116044347,99044347,comedy,music,romance
1035,23.029,5.6,4423,90000000,244041804,154041804,action,comedy,sci-fi
1036,7.815,6.1,116,10000000,575371,-9424629,action,comedy,crime
1037,7.778,5.6,420,35000000,2000000,-33000000,comedy,romance,sport
1039,0.6,7.5,1,2000000,28864,-1971136,drama,music,thriller
1040,6.021,6.6,230,3000000,0,-3000000,action,crime,drama
1041,9.435,5.6,1260,24000000,83531958,59531958,action,crime,sport
1044,25.215,5.4,2078,80000000,108469033,28469033,action,adventure,drama
1046,6.921,5.4,95,7500000,0,-7500000,crime,drama,thriller
1047,15.865,6.2,2667,120000000,142531552,22531552,action,adventure,sci-fi
1048,16.215999999999998,6.1,1979,40000000,127234389,87234389,action,adventure,sci-fi
1049,12.484000000000002,6.2,1244,35000000,31393201,-3606799,action,crime,thriller
1050,9.086,5.7,1195,28000000,16638300,-11361700,action,comedy,horror
1051,15.318,5.5,1157,60000000,84154026,24154026,action,adventure,fantasy
1052,14.357999999999999,8.0,5785,46000000,113402302,67402302,crime,drama,mystery
1053,9.55,6.5,1449,12000000,32909437,20909437,drama,mystery,sci-fi
1055,6.9110000000000005,6.0,276,8000000,10763183,2763183,comedy,drama,family
1056,24.98,6.4,7384,125000000,402448265,277448265,adventure,mystery,sci-fi
1058,9.371,5.5,259,30000000,21709539,-8290461,action,crime,drama
1060,9.078,6.3,1422,130000000,554987477,424987477,action,adventure,animation
1062,1.252,3.2,5,75000,0,-75000,action,sci-fi,thriller
1063,7.564,7.1,225,15000000,10055481,-4944519,biography,drama,sport
1064,7.109,6.0,136,36000000,1578543,-34421457,adventure,biography,drama
1065,21.377,5.6,2047,130000000,79076678,-50923322,action,adventure,comedy
1068,48.056999999999995,7.2,2626,175000000,524283695,349283695,adventure,animation,comedy
1069,7.442,6.3,460,15000000,27469621,12469621,adventure,comedy,family
1070,24.238000000000003,6.2,3176,120000000,428056280,308056280,action,adventure,sci-fi
1071,14.462,6.6,3412,135000000,245724600,110724600,adventure,animation,comedy
1072,8.48,5.4,123,12000000,2062406,-9937594,drama,horror,sci-fi
1075,4.659,5.2,48,5000000,0,-5000000,comedy,crime,drama
1076,30.029,7.6,7021,150000000,579290136,429290136,action,adventure,sci-fi
1078,14.811,6.8,4566,110000000,263880341,153880341,action,drama,family
1079,0.914,3.4,7,45000000,17492014,-27507986,horror,mystery,thriller
1081,14.994000000000002,6.5,2368,84000000,141507355,57507355,action,comedy,crime
1082,13.904000000000002,5.4,849,65000000,48164150,-16835850,action,sci-fi,thriller
1084,8.25,6.1,615,17700000,14518884,-3181116,drama,fantasy,horror
1085,11.856,5.9,1884,42000000,91678442,49678442,fantasy,horror,mystery
1088,18.117,6.5,3406,69000000,145951861,76951861,action,drama,thriller
1089,7.816,6.1,472,4000000,1983596,-2016404,action,crime,horror
1090,10.247,6.0,256,58000000,50365498,-7634502,action,adventure,drama
1091,0.6659999999999999,3.8,2,23000000,13593473,-9406527,adventure,drama,romance
1093,10.713,5.5,1065,20000000,15824374,-4175626,crime,horror,mystery
1096,12.437000000000001,6.2,976,32000000,18195238,-13804762,action,crime,sci-fi
1097,0.667,5.9,2119,57500000,295874190,238374190,action,adventure,horror
1098,1.325,5.7,2321,65000000,240647629,175647629,action,horror,sci-fi
1099,0.8440000000000001,5.9,1859,40000000,314101190,274101190,action,horror,sci-fi
1102,8.247,5.8,473,18000000,41166033,23166033,comedy,drama,music
1103,17.434,6.2,2852,38000000,94763758,56763758,action,adventure,sci-fi
1105,12.977,6.2,939,40000000,124827316,84827316,action,comedy,crime
1106,13.53,4.9,1785,25000000,82917283,57917283,drama,horror,mystery
1107,14.695,6.6,3730,90000000,487519809,397519809,adventure,animation,comedy
1108,18.11,6.3,1803,130000000,492846291,362846291,adventure,animation,comedy
1109,14.934000000000001,7.3,3697,145000000,306900902,161900902,action,adventure,animation
1110,22.995,7.2,7259,93000000,470986200,377986200,action,drama,sci-fi
1111,10.089,5.8,433,20000000,46255763,26255763,action,adventure,drama
1113,0.746,4.2,5,500000,0,-500000,drama,horror,mystery
1114,0.68,5.7,3,99000000,84747441,-14252559,action,adventure,drama
1115,17.851,5.8,3390,120000000,242981799,122981799,action,crime,sci-fi
1116,7.485,6.9,620,2500000,4934356,2434356,comedy,crime,drama
1117,10.362,5.7,123,60000000,24148488,-35851512,adventure,animation,comedy
1118,11.369000000000002,6.1,686,70000000,61031932,-8968068,comedy,drama,musical
1119,5.202999999999999,5.5,154,15000000,3386153,-11613847,comedy,music,war
1122,21.401,7.5,9296,200000000,1049102856,849102856,action,adventure,sci-fi
1123,12.687999999999999,6.2,499,22000000,12967012,-9032988,crime,drama,thriller
1124,2.0869999999999997,7.5,4,10000000,3275585,-6724415,biography,documentary,drama
1128,14.338,5.6,1096,20000000,46844357,26844357,comedy,crime,thriller
1129,8.318999999999999,5.9,417,500000,680914,180914,comedy,fantasy,horror
1130,8.03,7.4,149,5000000,567219,-4432781,comedy,drama,music
1131,17.592,6.4,1684,50000000,66961644,16961644,action,drama,thriller
1136,14.055,5.5,779,35000000,18376443,-16623557,action,crime,drama
1137,15.622,6.3,1248,33000000,41495213,8495213,action,crime,thriller
1138,9.095,7.1,1433,28000000,94050951,66050951,drama,romance,thriller
1140,9.214,6.9,792,750000,4422318,3672318,comedy,drama,romance
1141,0.632,1.0,1,130000000,290650494,160650494,action,mystery,thriller
1142,6.507000000000001,5.4,38,5500000,28468,-5471532,action,comedy,drama
1145,27.414,6.1,5125,110000000,456258539,346258539,action,adventure,drama
1146,7.457000000000001,5.9,515,30000000,108957098,78957098,adventure,drama,thriller
1147,15.232000000000001,5.6,4237,19000000,141344255,122344255,adventure,animation,comedy
1148,7.504,6.3,1246,45000000,82513490,37513490,crime,drama,thriller
1149,9.585,7.4,2050,35000000,114962525,79962525,biography,comedy,drama
1150,14.383,7.3,3882,85000000,48056764,-36943236,action,comedy,fantasy
1151,10.450999999999999,6.2,915,15000000,15554855,554855,action,comedy,horror
1155,12.535,5.3,1352,40000000,91126600,51126600,action,adventure,fantasy
1156,16.322,6.2,361,15700000,63288854,47588854,comedy,drama,romance
1157,6.892,6.3,696,20000000,32608019,12608019,crime,drama,mystery
1158,9.059,7.0,200,35000000,60376247,25376247,biography,drama,family
1159,8.092,6.4,1108,10000000,11766959,1766959,adventure,comedy,drama
1160,19.131,6.3,1815,26000000,33667319,7667319,action,mystery,sci-fi
1161,9.541,7.5,1354,20000000,66776576,46776576,biography,drama,history
1163,22.855999999999998,5.3,1549,95000000,108874967,13874967,action,adventure,fantasy
1164,9.986,5.9,809,95000000,294680778,199680778,comedy,drama,romance
1166,6.107,6.4,9,25000000,3645957,-21354043,adventure,animation,family
1168,6.824,6.1,80,50000000,15505922,-34494078,crime,drama,mystery
1169,3.5210000000000004,3.9,31,2000000,0,-2000000,action,adventure,crime
1172,12.987,5.4,343,59000000,87527651,28527651,adventure,animation,comedy
1174,18.301,7.1,6380,125000000,535663443,410663443,action,adventure,crime
1175,15.040999999999999,6.1,3843,165000000,756244673,591244673,adventure,animation,comedy
1176,10.535,5.2,374,10000000,11360665,1360665,drama,mystery,thriller
1179,20.468,7.3,4475,30000000,84393749,54393749,action,crime,drama
1180,29.725,6.7,1317,35000000,75885196,40885196,action,crime,drama
1181,0.657,7.3,2,200000,44701,-155299,crime,drama,mystery
1183,7.079,5.2,184,2000000,16610760,14610760,drama,horror,mystery
1184,15.350999999999999,7.1,7636,21000000,236412453,215412453,comedy,drama,romance
1187,17.572,6.9,4303,75000000,634454789,559454789,animation,comedy,family
1188,13.117,6.8,2935,3000000,87727807,84727807,horror,mystery,thriller
1189,9.916,5.8,1142,10000000,54104225,44104225,horror,mystery,thriller
1190,10.993,5.9,922,30000000,106030660,76030660,biography,comedy,documentary
1192,19.27,7.1,10441,200000000,1110526981,910526981,action,adventure,thriller
1193,8.847000000000001,4.8,833,10000000,68264973,58264973,action,sci-fi,thriller
1194,26.229,6.1,2177,125000000,304115534,179115534,action,adventure,thriller
1195,5.664,5.3,367,250000,3934450,3684450,action,drama,sci-fi
1196,16.999000000000002,4.0,712,10000000,51723644,41723644,adventure,comedy,horror
1197,5.3020000000000005,5.9,75,2000000,0,-2000000,comedy,crime,drama
1198,26.230999999999998,6.6,600,80000000,213691277,133691277,adventure,animation,comedy
1199,15.663,6.2,736,60000000,197578586,137578586,adventure,animation,comedy
1200,0.725,3.5,2,42000000,57852177,15852177,drama,horror,mystery
1201,16.673,5.9,1493,15000000,57907734,42907734,action,drama,thriller
1203,21.233,5.9,5258,170000000,401021746,231021746,action,adventure,drama
1205,13.703,7.1,2427,50000000,35380918,-14619082,biography,drama,thriller
1206,14.735,6.8,4748,40000000,88069880,48069880,action,drama,sci-fi
1207,29.502,6.6,3838,275000000,393151347,118151347,action,adventure,fantasy
1208,5.9079999999999995,6.1,59,300000,0,-300000,comedy,crime,drama
1209,7.567,6.1,591,35000000,65084116,30084116,comedy,drama,romance
1210,2.403,4.5,21,3000000,0,-3000000,drama,horror,mystery
1212,8.289,6.4,123,22000000,70949793,48949793,biography,drama,history
1214,15.887,6.9,481,3200000,18285560,15085560,comedy,fantasy,sci-fi
1215,8.459,7.0,688,18000000,47158652,29158652,biography,drama,family
1216,7.212000000000001,6.4,169,135000,429448,294448,drama,mystery,sci-fi
1217,13.495,7.2,4529,32000000,140428499,108428499,action,drama,sci-fi
1221,0.968,7.4,6,175000,2602,-172398,comedy,drama,romance
1223,30.318,6.4,6719,300000000,879620923,579620923,action,adventure,thriller
1225,46.775,7.4,11585,175000000,880166350,705166350,action,adventure,sci-fi
1226,25.783,7.2,10375,5000000,278964806,273964806,comedy,romance,sport
1228,10.690999999999999,5.0,2495,5000000,31149251,26149251,comedy,crime,drama
1230,8.799,6.2,415,4000000,679482,-3320518,drama,horror,sci-fi
1232,19.142,6.7,4275,185000000,335802233,150802233,action,adventure,sci-fi
1233,20.487,7.4,6182,190000000,467381584,277381584,action,adventure,sci-fi
1234,0.6,6.0,3,60000000,88832210,28832210,documentary,drama,sport
1236,17.174,6.7,1160,30000000,165889117,135889117,drama,music,romance
1237,10.925,6.8,1252,33000000,165552290,132552290,drama,music,romance
1242,9.812999999999999,5.3,559,35000000,17967746,-17032254,action,crime,thriller
1243,2.84,4.9,8,22000000,4065020,-17934980,crime,drama,thriller
1245,12.100999999999999,6.5,1308,70000000,183353431,113353431,adventure,animation,comedy
1247,11.731,7.7,2048,28000000,202182981,174182981,biography,drama,history
1249,5.91,5.2,135,10000000,161097,-9838903,drama,mystery,thriller
1250,8.749,5.7,255,25000000,11253821,-13746179,action,drama,thriller
1253,6.5729999999999995,5.1,91,2500000,0,-2500000,action,adventure,comedy
1255,7.412000000000001,7.4,770,1900000,4581937,2681937,comedy,drama,romance
1256,14.415999999999999,6.0,2716,75000000,89758389,14758389,action,adventure,fantasy
1257,7.763,7.3,982,14000000,34044909,20044909,biography,drama,history
1258,16.53,5.9,13533,175000000,746059887,571059887,action,adventure,fantasy
1260,11.36,6.6,726,2500000,593933,-1906067,action,comedy,drama
1261,14.39,6.7,3934,50000000,257972745,207972745,mystery,sci-fi,thriller
1262,12.046,6.5,130,16000000,20723581,4723581,action,crime,thriller
1265,3.412,4.8,55,20000000,1703281,-18296719,action,adventure,fantasy
1266,16.925,7.0,752,20000000,7034615,-12965385,fantasy,horror,mystery
1267,5.232,5.1,44,8000000,44197,-7955803,action,crime,drama
1268,10.0,6.9,1789,3000000,5837111,2837111,adventure,comedy,drama
1269,7.551,6.0,604,5000000,4620399,-379601,comedy,drama,romance
1271,11.321,6.1,339,19000000,7576604,-11423396,comedy,drama,romance
1272,11.235999999999999,7.2,787,4750000,4972016,222016,drama,horror,thriller
1275,8.969,6.2,605,32000000,70587268,38587268,action,crime,thriller
1277,21.511,7.5,6407,260000000,586477240,326477240,adventure,animation,comedy
1278,7.727,5.5,348,145000000,448191819,303191819,adventure,animation,drama
1281,4.486000000000001,7.6,11,1500000,98806,-1401194,action,comedy,crime
1282,16.523,7.0,304,10000000,51620593,41620593,action,animation,comedy
1283,25.619,5.8,4259,13500000,202000000,188500000,action,adventure,comedy
1284,15.095999999999998,5.9,1860,135000000,245328374,110328374,action,adventure,comedy
1289,9.251,7.4,486,10000000,6646669,-3353331,biography,drama,history
1291,0.6,6.0,1,20000000,9985316,-10014684,biography,drama,war
1294,11.575999999999999,5.3,799,30000000,56096200,26096200,biography,drama,thriller
1295,9.993,6.2,565,25000000,28400715,3400715,biography,drama,history
1296,2.142,4.7,15,6000000,408159,-5591841,biography,drama,sport
1297,12.967,5.8,3657,38000000,111336398,73336398,action,adventure,drama
1298,17.097,6.3,2703,110000000,177241171,67241171,action,adventure,thriller
1299,13.81,6.9,3407,40000000,152962083,112962083,action,crime,drama
1301,13.717,6.6,2615,50200000,126931325,76731325,romance,sci-fi,thriller
1302,8.417,5.1,108,25000000,0,-25000000,adventure,family,fantasy
1303,11.981,6.8,3251,130000000,373993951,243993951,action,adventure,animation
1304,8.559,7.4,3853,30000000,68984536,38984536,drama,fantasy,romance
1305,0.9109999999999999,4.5,2,1300000,0,-1300000,action,romance,thriller
1306,24.391,6.5,10411,220000000,757890267,537890267,action,adventure,sci-fi
1307,20.846999999999998,6.4,7220,200000000,708996336,508996336,action,adventure,sci-fi
1308,9.042,5.8,690,20000000,67950723,47950723,crime,drama,thriller
1309,17.998,6.0,1851,73000000,352327887,279327887,action,animation,comedy
1313,50.288999999999994,7.6,19673,225000000,1517935897,1292935897,action,adventure,sci-fi
1319,8.665,6.9,756,10000000,134639780,124639780,comedy,drama,romance
1323,20.08,6.2,1916,140000000,199646680,59646680,adventure,family,fantasy
1324,14.327,7.3,4657,28000000,133162752,105162752,biography,comedy,drama
1325,12.322000000000001,7.4,1302,5000000,53972860,48972860,comedy,drama,romance
1326,11.231,5.8,678,32500000,48425971,15925971,comedy,drama,romance
1328,8.152000000000001,6.5,328,110000,11000000,10890000,biography,drama,history
1330,18.985,6.7,3495,80000000,158750817,78750817,action,adventure,drama
1334,7.445,6.4,4314,125000000,510878762,385878762,adventure,animation,comedy
1336,9.861,5.7,1627,45000000,135808837,90808837,action,comedy,romance
1337,18.05,6.1,3630,125000000,280355920,155355920,action,adventure,thriller
1339,11.219000000000001,6.7,1016,60000000,111946251,51946251,adventure,animation,comedy
1340,11.703,5.8,2223,10000000,68220952,58220952,horror,mystery,thriller
1342,6.495,6.0,240,900000,413733,-486267,comedy,fantasy,thriller
1343,8.328,5.8,186,3500000,615816,-2884184,comedy,drama,sport
1344,9.847000000000001,5.1,678,7400000,31187727,23787727,drama,fantasy,horror
1353,17.382,6.3,3196,155000000,418186950,263186950,adventure,family,fantasy
1354,2.398,5.5,48,18000000,40651864,22651864,adventure,documentary,history
1356,0.84,7.0,1,10000000,8890094,-1109906,action,horror,thriller
1359,20.063,6.2,2394,40000000,101985431,61985431,action,mystery,thriller
1360,18.886,7.5,5912,20000000,318000141,298000141,horror,mystery,thriller
1363,10.55,5.1,1072,25000000,71009334,46009334,crime,drama,thriller
1367,16.29,6.8,3873,135000000,573068425,438068425,action,adventure,animation
1368,3.674,4.7,42,2000000,0,-2000000,drama,horror,mystery
1371,15.517000000000001,5.6,2842,60000000,113461527,53461527,action,adventure,fantasy
1373,23.967,6.8,1158,34000000,38361428,4361428,action,adventure,drama
1375,3.127,3.1,9,1100000,0,-1100000,action,horror,sci-fi
1376,12.697000000000001,6.6,403,20000000,46604054,26604054,drama,mystery,thriller
1379,7.505,6.7,291,19100000,5965646,-13134354,biography,drama,thriller
1380,9.382,6.7,460,2000000,2279959,279959,comedy,drama,romance
1384,6.324,4.4,272,15000000,3503761,-11496239,drama,horror,thriller
1385,13.27,7.2,1895,10000000,28717667,18717667,biography,comedy,drama
1386,1.5519999999999998,2.0,1,3000000,156362,-2843638,drama,horror,sci-fi
1390,8.443,6.1,694,25000000,38993548,13993548,action,adventure,drama
1391,8.044,6.6,438,6500000,3027956,-3472044,adventure,drama,thriller
1393,14.88,5.4,1447,50000000,216562312,166562312,adventure,animation,comedy
1394,28.941999999999997,7.2,4989,55000000,192903624,137903624,action,crime,thriller
1395,22.961,6.4,2089,77000000,190453132,113453132,action,crime,thriller
1396,21.517,6.1,4647,82000000,268268174,186268174,action,adventure,thriller
1397,17.215999999999998,6.2,4219,100000000,311979256,211979256,action,adventure,thriller
1398,18.797,6.1,2876,100000000,209461378,109461378,action,adventure,thriller
1401,5.519,6.1,68,4000000,1158877,-2841123,drama,mystery,romance
1402,1.141,6.3,3,30000000,51078541,21078541,comedy,crime,thriller
1403,28.668000000000003,6.9,6335,250000000,1234846267,984846267,action,crime,thriller
1405,28.651,7.7,2096,15000000,94113929,79113929,biography,drama,history
1406,6.611000000000001,5.9,549,26000000,6154172,-19845828,biography,drama,thriller
1407,10.395,7.3,2325,11000000,129262388,118262388,biography,drama,sport
1409,12.673,6.4,943,70000000,49252761,-20747239,action,drama,history
1410,28.44,5.8,1846,13000000,136617305,123617305,action,horror,sci-fi
1411,11.25,7.0,1426,2000000,17061,-1982939,comedy,drama,romance
1420,10.34,6.3,762,19200000,5617460,-13582540,crime,drama,mystery
1421,2.336,5.8,11,1000000,1239174,239174,drama,fantasy,romance
1422,9.166,4.8,591,100000,41656474,41556474,horror,mystery,thriller
1423,8.807,5.8,783,3000000,101773,-2898227,crime,drama,thriller
1424,4.534,7.2,51,1500000,2592308,1092308,documentary,history,war
1425,2.971,6.5,9,2000000,2436,-1997564,comedy,fantasy,musical
1426,7.829,6.8,1135,45000000,65532491,20532491,drama,mystery,thriller
1427,5.945,6.3,70,900000,7396,-892604,comedy,drama,romance
1429,1.595,5.9,25,45000000,174278214,129278214,crime,drama,mystery
1430,13.714,6.4,982,5250000,4801837,-448163,drama,horror,sci-fi
1431,17.823,7.3,3971,90000000,239373970,149373970,crime,drama,mystery
1432,8.687000000000001,6.5,3075,25000000,66540205,41540205,drama,romance,sci-fi
1433,17.675,6.7,3135,187500000,333771037,146271037,adventure,animation,comedy
1436,18.31,8.0,8091,31000000,163981261,132981261,adventure,comedy,crime
1439,22.009,8.0,5197,84000000,386665550,302665550,biography,drama,musical
1440,14.501,5.5,1897,110000000,229155503,119155503,action,comedy,crime
1442,12.942,6.5,2280,25000000,81249176,56249176,action,adventure,drama
1443,10.177,6.9,563,6000000,21197454,15197454,comedy,crime,thriller
1444,0.84,5.3,2,70000000,94973540,24973540,action,animation,fantasy
1446,10.388,5.7,583,40000000,18594227,-21405773,action,crime,drama
1447,1.9609999999999999,6.5,16,850000,442638,-407362,biography,drama,sport
1450,20.680999999999997,7.7,8065,62000000,147864886,85864886,crime,drama,mystery
1451,16.912,6.6,2441,43000000,229727774,186727774,action,comedy,crime
1454,26.939,7.2,12076,250000000,1017003568,767003568,adventure,family,fantasy
1458,11.458,6.2,2788,50000000,64477051,14477051,action,adventure,drama
1460,21.805,6.2,933,40000000,126331750,86331750,comedy,fantasy,horror
1462,14.212,7.1,14587,80000000,677923379,597923379,action,adventure,sci-fi
1463,20.187,7.4,11170,130000000,864868047,734868047,action,adventure,sci-fi
1464,33.836999999999996,6.8,10087,125000000,766575131,641575131,action,adventure,sci-fi
1465,19.487000000000002,6.8,7609,160000000,648986787,488986787,action,adventure,sci-fi
1467,13.335,5.4,476,40000000,30963684,-9036316,action,adventure,crime
1468,11.248,6.5,562,10000000,3623609,-6376391,biography,crime,drama
1472,33.078,8.1,10396,15000000,227740463,212740463,biography,drama,thriller
1474,14.66,7.2,3614,40000000,169590606,129590606,drama,history,thriller
1475,9.362,5.4,920,32000000,27392609,-4607391,adventure,comedy,fantasy
1476,9.588,6.6,943,47500000,20718104,-26781896,biography,crime,drama
1477,8.494,5.5,324,750000,1011535,261535,drama,horror,mystery
1487,12.255999999999998,6.3,3140,40000000,351774938,311774938,action,drama,family
1489,8.426,6.6,854,4000000,36275469,32275469,comedy,drama,romance
1490,7.087000000000001,5.9,304,13000000,3617277,-9382723,crime,drama,horror
1491,9.269,6.3,393,6000000,42320503,36320503,biography,comedy,drama
1492,16.595,4.6,2143,150000000,319713881,169713881,action,adventure,family
1493,8.759,5.3,407,10600000,261364,-10338636,adventure,horror,sci-fi
1494,9.35,5.6,519,1800000,70165900,68365900,drama,horror,thriller
1495,7.561,4.5,297,4000000,25448707,21448707,drama,horror,thriller
1496,5.079,5.9,230,2000000,205298,-1794702,comedy,drama,musical
1497,1.4,4.9,9,13400000,164247,-13235753,comedy,crime,romance
1498,9.237,7.2,2199,20000000,92678948,72678948,drama,music,romance
1500,16.685,5.8,2193,80000000,130818912,50818912,action,adventure,fantasy
1501,10.157,5.1,825,5000000,38359310,33359310,horror,mystery,sci-fi
1502,13.754000000000001,4.5,805,70000000,58953319,-11046681,action,adventure,fantasy
1503,14.797,5.8,4102,180000000,348902025,168902025,action,adventure,drama
1504,19.352,7.2,2882,80000000,310660018,230660018,action,animation,comedy
1505,19.375,7.4,4839,60000000,457729388,397729388,action,adventure,animation
1506,14.607000000000001,6.3,424,70000000,122737201,52737201,action,adventure,animation
1508,11.812000000000001,7.1,1525,40000000,87145086,47145086,crime,drama,thriller
1509,28.583000000000002,8.2,10160,79300000,986214868,906914868,adventure,animation,drama
1510,1.4,4.5,3,1500000,0,-1500000,biography,documentary,war
1511,8.512,7.6,1493,77500000,102028919,24528919,adventure,animation,drama
1512,15.64,6.9,2895,4500000,18019834,13519834,comedy,drama,romance
1513,12.482000000000001,6.0,3789,275000000,260002115,-14997885,action,adventure,western
1517,10.202,6.2,844,25000000,29863840,4863840,action,adventure,crime
1518,11.048,6.2,1397,30000000,17121823,-12878177,adventure,biography,drama
1519,2.164,5.5,21,2500000,549632,-1950368,adventure,family,fantasy
1521,5.232,4.7,47,35000000,53899,-34946101,action,adventure,romance
1525,18.487000000000002,6.2,3647,90000000,162525156,72525156,action,adventure,western
1527,18.956,7.1,3525,75000000,104949584,29949584,action,adventure,comedy
1530,22.855999999999998,7.7,12172,108000000,655271443,547271443,adventure,drama,sci-fi
1531,1.42,3.5,16,3500000,182695,-3317305,action,biography,crime
1533,36.955,7.1,10626,34000000,348319861,314319861,action,mystery,sci-fi
1534,14.387,6.3,1676,42500000,76347393,33847393,action,crime,thriller
1535,7.725,5.8,186,3200000,5526942,2326942,comedy,drama,romance
1536,31.397,5.9,2896,178000000,529530715,351530715,action,horror,sci-fi
1537,0.6,8.0,2,6500000,1744952,-4755048,drama,mystery,thriller
1538,12.860999999999999,5.9,2229,70000000,158702748,88702748,comedy,drama,history
1539,16.484,6.3,2915,60000000,75965567,15965567,action,fantasy,horror
1540,6.1610000000000005,6.4,77,50000000,170857676,120857676,crime,drama,thriller
1541,18.53,5.5,4391,195000000,409953905,214953905,action,adventure,fantasy
1542,11.324000000000002,6.6,831,45000000,160971922,115971922,adventure,comedy,family
1544,11.147,7.0,1469,30000000,67255916,37255916,action,crime,drama
1545,13.743,7.1,4272,50000000,59596747,9596747,action,comedy,crime
1547,0.6709999999999999,4.5,2,100000,0,-100000,horror,sci-fi,thriller
1548,17.747,6.1,852,15000000,34820335,19820335,action,crime,thriller
1549,10.501,5.6,529,30000000,122529966,92529966,adventure,animation,comedy
1550,8.975,5.7,227,40000000,57438389,17438389,adventure,animation,comedy
1551,26.235,6.0,909,132900000,170293899,37393899,adventure,family,fantasy
1552,7.566,5.5,97,90000000,20466016,-69533984,action,family,fantasy
1553,9.216000000000001,6.7,605,40000000,55249159,15249159,comedy,drama,family
1554,1.29,5.6,5,49000000,72689126,23689126,comedy,drama,romance
1555,1.578,2.6,9,20000000,1065907,-18934093,adventure,family,fantasy
1558,13.508,6.2,2187,100000000,170936470,70936470,action,comedy,crime
1563,8.142999999999999,5.5,409,12500000,4027663,-8472337,crime,drama,mystery
1564,0.6,5.5,2,100000,20056,-79944,biography,documentary,music
1565,11.344000000000001,6.6,894,99000000,250091610,151091610,adventure,animation,comedy
1566,6.727,5.7,211,18000000,60278166,42278166,crime,drama,horror
1571,12.96,6.9,2781,15000000,47011449,32011449,crime,drama,thriller
1573,8.978,5.9,918,14000000,82925064,68925064,horror,mystery,thriller
1574,20.262999999999998,5.1,393,6000000,42785387,36785387,horror,mystery,thriller
1575,15.550999999999998,7.0,2506,50000000,179748880,129748880,biography,drama,history
1576,29.473000000000003,5.2,2018,88000000,159487563,71487563,action,adventure,sci-fi
1580,28.424,6.6,3754,9000000,111534881,102534881,action,horror,sci-fi
1581,18.975,6.3,2900,10000000,118514727,108514727,action,horror,sci-fi
1582,9.582,6.9,408,18000000,23910210,5910210,biography,drama,romance
1583,0.6,5.9,5,26000000,30601801,4601801,crime,mystery,thriller
1584,5.172999999999999,5.6,264,10000000,15037867,5037867,adventure,drama,horror
1586,1.5090000000000001,6.7,10,2000000,2303792,303792,comedy,drama,family
1588,19.41,7.4,11064,135000000,532938302,397938302,action,adventure,biography
1591,9.676,5.9,994,37000000,97143987,60143987,drama,horror,mystery
1592,2.948,5.1,24,25000000,29206732,4206732,adventure,documentary,war
1594,13.527999999999999,6.2,435,8500000,3180252,-5319748,action,crime,drama
1596,8.19,6.4,448,9500000,5278632,-4221368,biography,drama,music
1598,6.16,6.7,97,9000000,20395040,11395040,biography,comedy,drama
1600,9.908999999999999,6.1,5374,75000000,886750534,811750534,adventure,animation,comedy
1601,10.743,7.1,4859,91000000,187861183,96861183,adventure,comedy,drama
1602,6.46,6.9,296,1000000,11495204,10495204,biography,comedy,drama
1603,14.091,6.3,3037,13000000,118763442,105763442,drama,horror,thriller
1604,22.025,7.2,7224,19500000,195790794,176290794,adventure,drama,fantasy
1605,0.6609999999999999,7.0,2,50000,406299,356299,drama,mystery,sci-fi
1606,3.3139999999999996,6.4,51,1000000,6870,-993130,drama,mystery,thriller
1607,13.738,7.0,590,38000000,13143056,-24856944,adventure,comedy,crime
1609,10.341,6.7,394,1000000,5797192,4797192,comedy,drama,romance
1611,16.533,5.6,2112,110000000,563749323,453749323,adventure,animation,comedy
1612,12.940999999999999,5.7,1200,110000000,348547523,238547523,adventure,animation,comedy
1613,14.581,5.1,1225,35000000,43226146,8226146,crime,drama,mystery
1615,7.586,5.1,156,15000000,1148578,-13851422,action,crime,drama
1616,14.463,5.9,2879,160000000,217986320,57986320,action,adventure,family
1617,14.437000000000001,7.1,1455,30000000,16481405,-13518595,adventure,drama,romance
1618,13.679,6.6,1801,2500000,6916951,4416951,comedy,drama,romance
1619,13.815,5.7,1165,74000000,311013181,237013181,adventure,animation,comedy
1620,10.745999999999999,5.7,650,28000000,46752858,18752858,action,comedy,family
1622,14.53,5.4,233,20000000,62758010,42758010,adventure,animation,comedy
1624,6.4,5.9,142,4500000,8000366,3500366,action,crime,drama
1625,7.745,6.1,1008,19000000,49858465,30858465,comedy,drama,romance
1626,6.3,5.8,52,20000000,277943,-19722057,comedy,drama,fantasy
1627,13.866,7.9,6412,15000000,123327692,108327692,biography,drama,romance
1628,12.349,6.1,1404,38000000,27573078,-10426922,horror,mystery,sci-fi
1629,11.932,5.7,1596,90000000,139877913,49877913,action,adventure,romance
1632,10.307,6.1,3133,100000000,278731369,178731369,action,adventure,thriller
1634,13.427999999999999,5.4,836,22000000,69698495,47698495,action,adventure,crime
1636,20.34,6.0,4909,68000000,706102828,638102828,adventure,drama,fantasy
1642,0.631,8.0,1,5000000,98677816,93677816,comedy,drama,romance
1644,11.754000000000001,6.9,1906,35000000,61492104,26492104,adventure,biography,drama
1647,8.259,6.1,203,42000000,8514325,-33485675,action,fantasy,western
1648,10.228,5.4,1356,55000000,67130045,12130045,action,comedy,horror
1650,11.479000000000001,6.8,682,22500000,31054727,8554727,drama,history,war
1655,29.518,7.9,12411,100000000,389870414,289870414,biography,crime,drama
1656,14.03,5.7,1009,150000000,142634358,-7365642,drama,fantasy,horror
1657,4.323,6.3,6176,115000000,416456852,301456852,action,adventure,sci-fi
1658,12.780999999999999,6.1,2122,15000000,128955898,113955898,drama,fantasy,horror
1660,7.2010000000000005,6.6,628,6000000,16369708,10369708,drama,mystery,romance
1661,12.719000000000001,6.7,2990,20000000,47508505,27508505,action,comedy,sci-fi
1662,7.285,6.7,389,33000000,357687,-32642313,action,adventure,comedy
1664,7.058,5.1,93,36000000,4020990,-31979010,biography,drama,war
1673,12.017000000000001,6.0,2096,65000000,156974557,91974557,action,comedy,romance
1674,38.068000000000005,6.7,12764,150000000,449326618,299326618,action,adventure,fantasy
1675,43.45,7.5,11380,180000000,846980024,666980024,action,adventure,comedy
1676,31.014,6.7,10171,150000000,644602516,494602516,action,adventure,fantasy
1677,11.241,6.3,398,5000000,3187302,-1812698,comedy,crime,drama
1679,6.781000000000001,6.3,196,34000000,62582520,28582520,adventure,animation,comedy
1683,10.831,6.7,1402,21000000,81452811,60452811,drama,mystery,thriller
1684,6.695,5.9,82,50000,424149,374149,comedy,drama,romance
1685,9.562999999999999,5.7,1097,21500000,74326015,52826015,comedy,music,romance
1686,6.327999999999999,6.8,66,3400000,0,-3400000,biography,drama,fantasy
1687,24.968000000000004,6.3,4310,90000000,273477501,183477501,action,adventure,fantasy
1688,20.136,6.2,4610,170000000,206627518,36627518,action,adventure,family
1689,12.65,5.3,1058,48000000,112610386,64610386,comedy,family,fantasy
1692,17.243,5.9,3486,125000000,211856088,86856088,action,adventure,mystery
1693,12.213,6.0,1592,85000000,150422946,65422946,action,comedy,crime
1694,24.445,7.7,8340,200000000,1068879522,868879522,adventure,animation,comedy
1695,3.5810000000000004,6.7,29,6500000,3149,-6496851,action,adventure,drama
1697,18.423,5.8,1731,35000000,141123897,106123897,comedy,drama,romance
1699,11.035,6.0,3491,100000000,103039258,3039258,action,drama,sci-fi
1700,20.961,5.8,4805,210000000,1104039076,894039076,action,adventure,sci-fi
1701,5.3389999999999995,6.1,4961,195000000,1123790543,928790543,action,adventure,sci-fi
1702,24.258000000000003,6.0,3255,217000000,602893340,385893340,action,adventure,sci-fi
1707,11.909,5.5,589,35000000,786532,-34213468,crime,drama,thriller
1708,7.761,6.8,1094,12000000,1594955,-10405045,family,fantasy,music
1710,16.285999999999998,6.6,1880,125000000,344150134,219150134,adventure,animation,comedy
1711,13.459000000000001,6.3,4387,200000000,400062763,200062763,action,adventure,fantasy
1713,13.118,7.2,2816,35000000,252276928,217276928,adventure,drama,western
1716,9.89,6.4,307,25000000,6792768,-18207232,drama,history,romance
1717,14.876,6.1,1758,135000000,286896578,151896578,adventure,animation,comedy
1718,1.073,5.6,5,55000000,11532774,-43467226,action,drama,thriller
1719,8.655,5.3,601,3000000,1887554,-1112446,comedy,drama,horror
1720,6.12,5.0,132,7000000,1268346,-5731654,comedy,fantasy,horror
1722,12.354000000000001,7.4,2240,65000000,163527824,98527824,biography,drama,sport
1724,3.705,5.5,42,20000000,18826490,-1173510,comedy,drama,romance
1725,9.527000000000001,6.1,1781,13300000,7229933,-6070067,drama,horror,sci-fi
1727,18.976,5.5,2318,35000000,81209222,46209222,action,adventure,fantasy
1730,8.12,5.4,2019,1000000,64364198,63364198,horror,mystery,thriller
1731,17.861,6.1,365,1000000,16434588,15434588,crime,horror,mystery
1733,1.5190000000000001,3.3,21,30000000,168832,-29831168,drama,history,sport
1734,12.08,6.6,2043,40000000,136123083,96123083,action,mystery,thriller
1735,4.652,4.3,22,3000000,0,-3000000,action,horror,sci-fi
1736,16.316,6.2,667,1500000,14244931,12744931,drama,horror,mystery
1738,2.478,3.3,3,1500000,510957,-989043,action,horror,thriller
1741,11.220999999999998,5.9,328,40000000,1663785,-38336215,action,drama,history
1744,24.003,6.6,4149,180000000,215098356,35098356,action,adventure,fantasy
1745,2.989,6.0,12,20000000,20268825,268825,comedy,fantasy,horror
1747,6.65,5.0,145,16000000,94812,-15905188,comedy,horror,thriller
1749,7.821000000000001,6.7,699,6000000,3485383,-2514617,crime,drama,mystery
1751,14.640999999999998,4.3,312,60000000,70883171,10883171,action,adventure,sci-fi
1752,9.061,5.8,1200,40000000,31124367,-8875633,drama,horror,sci-fi
1756,10.654000000000002,6.8,2387,50000000,86234503,36234503,comedy,crime,drama
1757,23.445,7.0,5235,152000000,489592267,337592267,action,adventure,drama
1761,21.464000000000002,6.3,4071,160000000,425522281,265522281,action,adventure,fantasy
1762,13.259,6.3,4109,30000000,115121608,85121608,comedy,horror,romance
1766,10.809000000000001,6.3,1241,2000000,10153415,8153415,drama,music,romance
1767,9.931000000000001,6.7,1523,50000000,118729073,68729073,comedy,drama,family
1768,11.964,7.6,1306,7000000,10765283,3765283,drama,mystery,thriller
1771,22.031999999999996,6.6,286,45000000,12874922,-32125078,biography,comedy,drama
1773,12.27,5.9,1130,37500000,88473016,50973016,comedy,drama,romance
1774,1.9169999999999998,6.6,13,65000000,374105123,309105123,comedy,romance,sci-fi
1776,8.062000000000001,5.3,150,10000000,30768449,20768449,crime,drama,horror
1777,6.08,6.6,185,15000000,30138912,15138912,drama,family,sport
1778,8.022,5.9,609,10000000,17503828,7503828,comedy,drama,mystery
1780,8.564,6.2,596,35000000,25350747,-9649253,biography,comedy,drama
1783,13.026,6.4,2817,150000000,205440387,55440387,action,drama,thriller
1784,6.636,5.9,49,20000000,60831067,40831067,comedy,drama,romance
1787,10.097999999999999,7.0,1454,15000000,52460543,37460543,adventure,biography,drama
1788,0.917,8.0,1,30000000,4315789,-25684211,action,crime,drama
1789,9.355,6.4,356,8000000,5314194,-2685806,action,comedy,crime
1791,12.44,5.7,884,3500000,44378040,40878040,biography,drama,fantasy
1792,1.3880000000000001,6.0,8,2000000,0,-2000000,action,horror,thriller
1794,3.2119999999999997,3.8,12,2000000,0,-2000000,adventure,animation,comedy
1795,1.88,5.7,6,15000000,61847,-14938153,biography,drama,history
1796,11.147,6.9,444,30000000,50145607,20145607,adventure,animation,comedy
1799,10.219,5.4,690,12000000,23477345,11477345,drama,fantasy,horror
1802,8.627,5.8,151,18000000,94953,-17905047,action,fantasy,horror
1803,7.76,7.4,787,11000000,58586407,47586407,biography,drama,history
1804,8.482999999999999,6.1,159,13000000,0,-13000000,drama,romance,sci-fi
1807,31.618000000000002,7.3,12566,150000000,821133378,671133378,action,adventure,fantasy
1810,14.582,6.7,9132,190000000,531514650,341514650,action,adventure,horror
1811,14.991,5.6,2442,150000000,305270083,155270083,action,adventure,fantasy
1812,22.967,7.3,7780,165000000,496511521,331511521,adventure,animation,comedy
1814,39.293,6.5,8348,178000000,542537546,364537546,action,adventure,sci-fi
1815,41.867,7.5,10062,200000000,747862775,547862775,action,adventure,sci-fi
1816,1.4469999999999998,7.2,8211,160000000,355408305,195408305,action,adventure,sci-fi
1817,21.749000000000002,5.6,2452,85000000,345033359,260033359,action,adventure,thriller
1818,8.05,4.5,221,5000000,22958,-4977042,action,comedy,fantasy
1819,9.096,5.3,387,80000000,204774690,124774690,adventure,animation,comedy
1820,10.208,6.2,734,20000000,32838945,12838945,comedy,family,romance
1821,6.209,5.8,431,15000000,34247816,19247816,comedy,drama,romance
1822,11.45,6.6,1258,1000000,26887177,25887177,action,comedy,horror
1824,0.6,3.0,4,50000000,26121638,-23878362,adventure,comedy,fantasy
1827,7.931,5.6,131,20000000,34454336,14454336,adventure,animation,comedy
1830,10.764000000000001,5.3,886,80000000,170805525,90805525,comedy,family,romance
1832,3.4339999999999997,5.5,43,35000000,12506188,-22493812,comedy,drama,romance
1833,27.549,7.7,9977,150000000,1019429616,869429616,adventure,animation,comedy
