,popularity,vote_average,vote_count,production_budget,worldwide_gross,profit,genre
0,6.099,3.3,102,1500000,0,-1500000,crime
1,17.892,6.9,4629,5000000,108286422,103286422,drama
2,0.955,5.4,7,12000000,14616,-11985384,drama
3,13.183,5.6,1312,35000000,71118378,36118378,action
4,16.493,7.9,6631,20000000,181025343,161025343,biography
5,11.435,7.0,4469,18000000,60217171,42217171,adventure
6,10.899000000000001,6.3,576,4000000,47552,-3952448,horror
7,0.6,7.5,2,1000000,0,-1000000,drama
8,14.8,6.5,2368,61000000,132493015,71493015,action
9,7.8660000000000005,7.4,127,1000000,5892466,4892466,documentary
10,14.835999999999999,6.8,6527,42000000,202812429,160812429,action
11,11.175999999999998,6.9,5167,50000000,331333876,281333876,action
12,2.213,6.5,31,1000000,549185,-450815,drama
13,1.8159999999999998,6.0,2,7200000,295492,-6904508,drama
14,2.079,4.3,6,300000,39475,-260525,drama
15,11.011,6.1,1279,28000000,38959900,10959900,action
16,11.315,5.6,825,28000000,40966716,12966716,action
17,2.967,3.0,42,3000000,0,-3000000,comedy
18,23.68,6.0,3870,110000000,330780051,220780051,action
19,8.683,5.2,370,1500000,922727,-577273,horror
20,11.28,7.0,1028,31000000,97470701,66470701,biography
21,25.049,6.0,2080,175000000,151716815,-23283185,action
22,8.689,5.7,102,12000000,87793,-11912207,action
23,2.852,6.2,25,10000000,1069454,-8930546,drama
24,12.450999999999999,7.1,2111,8000000,41334735,33334735,documentary
25,0.84,8.0,2,2500000,0,-2500000,drama
26,2.19,6.2,11,2500000,100280,-2399720,documentary
27,5.797999999999999,5.3,63,5000000,4816142,-183858,drama
28,16.604,6.3,1044,28000000,127710550,99710550,adventure
29,5.885,7.1,97,10000000,1884251,-8115749,drama
30,10.352,6.3,1066,20000000,14807531,-5192469,biography
31,8.84,5.8,247,15000000,17224539,2224539,comedy
32,11.886,7.0,906,100000,2769782,2669782,drama
33,15.857999999999999,5.2,4437,92000000,304249198,212249198,action
34,6.909,5.5,871,2500000,59922558,57422558,comedy
35,6.9479999999999995,5.5,597,4000000,21206861,17206861,comedy
36,11.055,5.9,589,35000000,11846010,-23153990,comedy
37,7.87,6.3,333,12500000,1100287,-11399713,comedy
38,9.104,6.1,251,4000000,442550,-3557450,adventure
39,10.815999999999999,5.8,2219,40000000,86778557,46778557,comedy
40,11.128,7.1,1918,43000000,46414530,3414530,animation
41,12.270999999999999,6.6,792,20000000,8846875,-11153125,crime
42,10.267000000000001,6.5,784,15000000,36068890,21068890,crime
43,9.795,5.5,1408,35000000,117729621,82729621,crime
44,29.154,7.3,5848,17000000,334522294,317522294,drama
45,21.121,6.6,1756,20000000,97628717,77628717,comedy
46,35.848,7.5,5676,36000000,433449571,397449571,documentary
47,7.12,7.5,500,8000000,17382693,9382693,biography
48,8.017000000000001,6.1,685,40000000,20790486,-19209514,comedy
49,1.218,6.6,4,45000,0,-45000,comedy
50,19.373,6.3,1685,28000000,62108587,34108587,action
51,6.935,5.9,402,8000000,37119358,29119358,adventure
52,12.529000000000002,5.0,1073,103000000,133401882,30401882,adventure
53,17.69,5.8,1791,35000000,86648359,51648359,action
54,8.465,6.0,312,13000000,50445860,37445860,comedy
55,14.133,7.9,3981,12000000,89309178,77309178,comedy
56,0.782,8.0,5,1300000,288751,-1011249,documentary
57,12.498,5.6,2009,67500000,137489730,69989730,action
58,10.357000000000001,5.9,175,70000,8555,-61445,sci-fi
59,6.487,4.0,172,26000000,135436,-25864564,comedy
60,10.6,6.6,186,20000000,46627836,26627836,drama
61,12.197000000000001,6.3,583,12000000,82497035,70497035,action
62,6.744,5.2,81,7000000,20257000,13257000,action
63,12.84,5.2,136,19000000,5103675,-13896325,comedy
64,8.295,5.3,103,5000000,17499242,12499242,drama
65,5.466,6.4,86,20000000,38585047,18585047,action
66,8.065,5.5,385,13000000,18733666,5733666,comedy
67,16.785999999999998,6.7,1264,35000000,57897191,22897191,drama
68,8.058,5.2,29,750000,0,-750000,crime
69,7.712000000000001,5.7,86,650000,0,-650000,drama
70,14.415,5.1,4154,130000000,251499665,121499665,action
71,8.166,6.2,217,5000000,1075009,-3924991,crime
72,6.971,3.9,56,65000000,516279,-64483721,action
73,2.877,3.9,31,1200000,0,-1200000,comedy
74,6.277,6.3,227,7500000,8539003,1039003,drama
75,9.962,5.1,424,35000000,35426759,426759,action
76,6.7829999999999995,6.2,817,28000000,101379287,73379287,comedy
77,22.02,6.6,8713,3000000,0,-3000000,fantasy
78,16.642,6.5,3803,170000000,276928112,106928112,adventure
79,24.651,5.9,4971,97000000,238521247,141521247,horror
80,7.249,6.4,695,45000000,54876855,9876855,biography
81,7.871,6.0,493,20000000,873617,-19126383,crime
82,9.869,6.6,949,8500000,10386814,1886814,action
83,4.042,6.1,25,2000000,5941994,3941994,drama
84,2.0780000000000003,3.9,19,20000,0,-20000,sci-fi
85,3.0580000000000003,7.0,9,500000,0,-500000,horror
86,19.611,6.7,2765,106000000,119266661,13266661,action
87,6.532,5.6,245,17000000,42493506,25493506,comedy
88,11.022,7.5,1339,60000000,47371191,-12628809,comedy
89,4.944,5.5,61,8000000,237688,-7762312,drama
90,9.685,5.3,1226,37000000,25387091,-11612909,comedy
91,24.535999999999998,5.9,1167,51000000,99624873,48624873,adventure
92,12.672,5.5,1055,80000000,349088523,269088523,adventure
93,14.972999999999999,5.8,852,90000000,249517956,159517956,adventure
94,15.434000000000001,6.3,1596,63000000,68310140,5310140,action
95,7.271,4.6,213,10000000,2341218,-7658782,action
96,6.56,5.0,93,1000000,26,-999974,action
97,8.777999999999999,6.7,417,3500000,2611750,-888250,adventure
98,12.481,6.8,4443,40000000,257878294,217878294,crime
99,16.748,6.7,2188,50000000,135569212,85569212,action
100,17.199,6.2,2679,50000000,236799211,186799211,comedy
101,18.473,7.4,7658,58000000,547326372,489326372,action
102,9.97,6.0,1756,28000000,30295028,2295028,action
103,0.84,4.8,4,1500000,184705,-1315295,drama
104,6.144,4.5,95,3000000,0,-3000000,drama
105,10.705,7.7,746,9700000,36787044,27087044,drama
106,12.08,6.1,1408,50000000,172185754,122185754,comedy
107,8.235,5.9,264,18000000,17920013,-79987,comedy
108,0.6,5.0,1,300000,0,-300000,comedy
109,10.187999999999999,6.8,399,4200000,8078683,3878683,crime
110,0.6,6.5,2,5500000,0,-5500000,drama
111,1.463,3.1,8,4357373,1200000,-3157373,biography
112,9.987,6.7,1265,49000000,71004627,22004627,drama
113,13.989,5.6,3357,6500000,256862920,250362920,horror
114,21.245,6.5,3141,15000000,305384865,290384865,horror
115,13.422,6.1,770,65000000,139829625,74829625,drama
116,25.197,6.3,4465,55000000,43070915,-11929085,adventure
117,10.285,7.1,927,8000000,5706168,-2293832,animation
118,8.113999999999999,6.4,434,27500000,15815509,-11684491,action
119,10.03,6.7,853,175000,2102779,1927779,drama
120,5.473,6.1,60,4000000,978527,-3021473,comedy
121,9.394,7.0,150,8000000,20005613,12005613,documentary
122,32.715,7.1,11949,130000000,518858449,388858449,action
123,44.729,7.0,6290,130000000,623144660,493144660,action
124,2.061,7.2,41,1000000,288757,-711243,adventure
125,5.716,4.8,66,2500000,0,-2500000,horror
126,6.33,5.8,152,3100000,123407,-2976593,horror
127,8.384,5.0,486,5000000,26517819,21517819,horror
128,38.102,6.8,6155,160000000,1146894640,986894640,action
129,12.14,6.2,459,12000000,35830713,23830713,drama
130,6.794,4.4,248,5000000,7556,-4992444,horror
131,15.793,7.2,5127,44500000,227140757,182640757,biography
132,2.017,6.6,18,150000,0,-150000,documentary
133,25.441999999999997,7.4,10387,47000000,203127894,156127894,documentary
134,7.886,5.5,399,40000000,47787943,7787943,comedy
135,12.981,6.7,692,85000000,149717124,64717124,adventure
136,10.613,6.2,1321,5000000,41824066,36824066,adventure
137,0.629,8.0,1,450000,13486,-436514,drama
138,9.193,5.6,246,950000,0,-950000,drama
139,10.579,6.2,666,50000000,83306268,33306268,action
140,21.662,6.3,3645,30000000,98345423,68345423,action
141,9.612,6.4,1144,13000000,6459183,-6540817,action
142,1.505,5.7,6,3400000,12636,-3387364,drama
143,9.586,6.9,843,25000000,50738810,25738810,comedy
144,26.526,7.4,18676,425000000,2776345279,2351345279,horror
145,44.383,7.3,13457,330600000,1403013963,1072413963,action
146,80.773,8.3,13948,300000000,2048134200,1748134200,action
147,4.2,3.8,22,3000000,0,-3000000,action
148,10.405999999999999,7.0,252,30000000,263502914,233502914,action
149,22.895,7.4,8034,34000000,228104185,194104185,action
150,7.05,5.4,755,3000000,12577401,9577401,comedy
151,13.292,6.3,78,8000000,343773,-7656227,drama
152,1.8359999999999999,10.0,1,70000000,69157016,-842984,thriller
153,14.332,6.5,2600,20000000,180998716,160998716,comedy
154,13.549000000000001,5.5,2894,19000000,215448997,196448997,comedy
155,31.32,6.8,1365,32000000,29204379,-2795621,crime
156,9.516,6.4,451,10000000,7843145,-2156855,comedy
157,8.666,5.4,127,8500000,22885836,14385836,comedy
158,7.117000000000001,5.5,358,35000000,15471969,-19528031,drama
159,7.122000000000001,7.9,232,13000000,121778347,108778347,action
160,13.21,7.2,1024,30000000,96892829,66892829,biography
161,6.872000000000001,5.6,135,950000,78122,-871878,horror
162,7.874,5.8,383,10000000,247565,-9752435,comedy
163,12.845999999999998,6.0,248,20000000,54404202,34404202,comedy
164,7.357,7.2,210,30000000,8845575,-21154425,comedy
165,5.141,6.0,37,3000000,0,-3000000,comedy
166,28.088,5.8,11991,250000000,867500281,617500281,action
167,11.988,6.9,1045,25000000,18445379,-6554621,biography
168,5.858,6.1,130,20000000,16723377,-3276623,drama
169,21.741999999999997,5.6,3240,220000000,313477717,93477717,action
170,14.429,6.1,4748,60000000,175863783,115863783,action
171,10.136000000000001,6.1,1748,17000000,38028230,21028230,drama
172,7.53,6.9,605,1800000,23265132,21465132,adventure
173,0.879,8.0,1,9000000,3134509,-5865491,biography
174,17.409000000000002,7.6,500,25000000,13031424,-11968576,drama
175,11.198,5.7,1826,50000000,60282876,10282876,drama
176,26.701,7.7,5730,160000000,1259199706,1099199706,family
177,14.584000000000001,7.0,2135,5000000,18945682,13945682,drama
178,16.07,6.4,1098,22000000,19563579,-2436421,drama
179,11.765,7.4,1039,3000000,23251930,20251930,drama
180,8.232999999999999,6.5,985,3000000,483938,-2516062,documentary
181,10.828,7.2,2089,8000000,68838736,60838736,drama
182,10.322000000000001,6.9,532,3200000,14314407,11114407,comedy
183,1.327,5.9,12,3500000,890303,-2609697,documentary
184,5.599,6.7,31,53000000,22852487,-30147513,documentary
185,2.0269999999999997,5.2,17,1200000,0,-1200000,thriller
186,17.273,6.7,254,13000000,9633111,-3366889,drama
187,10.11,5.6,1068,15000000,73259017,58259017,action
188,0.6,5.0,1,50000,0,-50000,documentary
189,6.067,7.0,66,9000000,3440939,-5559061,drama
190,10.503,7.0,138,500000,31559560,31059560,documentary
191,7.518,6.6,503,6000000,10106975,4106975,biography
192,7.331,5.9,150,1100000,56491,-1043509,horror
193,7.7170000000000005,7.0,238,7000000,14618727,7618727,drama
194,15.030999999999999,7.0,1813,18000000,151668774,133668774,documentary
195,12.017000000000001,7.0,2153,10000000,27317872,17317872,documentary
196,36.92,7.8,10176,165000000,652127828,487127828,action
197,6.76,6.6,250,40000000,25268680,-14731320,biography
198,16.024,5.5,623,32000000,82332450,50332450,action
199,2.707,6.8,54,30000000,648599,-29351401,action
200,26.156,7.0,4777,19800000,0,-19800000,drama
201,8.164,5.7,172,31000000,7220490,-23779510,action
202,5.489,6.2,42,21000000,606162,-20393838,drama
203,7.697,7.2,546,35000000,24687524,-10312476,drama
204,14.645999999999999,6.4,2020,53000000,98837872,45837872,biography
205,1.7790000000000001,5.7,25,17500000,7285135,-10214865,drama
206,1.3659999999999999,5.9,5,7500000,32572,-7467428,action
207,8.05,6.8,193,9000000,21971021,12971021,action
208,2.0580000000000003,5.1,11,200000000,1348258224,1148258224,action
209,6.334,4.9,118,1000000,0,-1000000,horror
210,13.745,7.6,8374,13000000,331266710,318266710,drama
211,16.824,5.3,1165,70000000,19665004,-50334996,action
212,25.101,7.6,3138,15000000,93017335,78017335,biography
213,7.547999999999999,6.7,111,4500000,1217307,-3282693,action
214,48.571000000000005,7.4,6679,185000000,259357408,74357408,drama
215,9.772,5.0,1094,10000000,38985577,28985577,horror
216,8.258,6.9,405,16000000,6603926,-9396074,biography
217,0.6,6.0,2,1200000,0,-1200000,horror
218,10.613,6.7,1709,45000000,127990741,82990741,comedy
219,21.840999999999998,6.1,969,21000000,94045328,73045328,comedy
220,1.3459999999999999,6.0,5,10000000,109383,-9890617,drama
221,3.4019999999999997,4.3,6,1200000,8708,-1191292,horror
222,12.003,6.1,268,26000000,2923959,-23076041,action
223,10.443,7.0,1983,18000000,102912961,84912961,drama
224,3.253,5.9,35,1200000,595018,-604982,comedy
225,7.983,6.9,736,420000,437002,17002,crime
226,8.994,6.9,1677,1000000,16566240,15566240,drama
227,1.881,6.6,10,14000000,20597806,6597806,biography
228,37.196999999999996,8.1,7629,55000000,894985342,839985342,biography
229,11.890999999999998,6.8,905,2000000,475846,-1524154,adventure
230,1.4,8.0,4,10000000,8378853,-1621147,documentary
231,0.6,10.0,1,10000000,91113683,81113683,documentary
232,1.375,4.3,9,5000000,0,-5000000,action
233,0.6,5.5,2,500000,1822,-498178,action
234,5.882999999999999,3.5,42,4500000,7011317,2511317,adventure
235,11.140999999999998,7.5,3097,4000000,57273049,53273049,drama
236,5.972,6.4,18,1660000,80745,-1579255,horror
237,18.908,6.9,8116,185000000,554606532,369606532,drama
238,0.6,2.5,2,6000000,51411620,45411620,action
239,4.236000000000001,5.4,18,7000000,19910002,12910002,comedy
240,9.193999999999999,5.9,909,28000000,73421224,45421224,action
241,9.805,6.5,2783,32500000,289632023,257132023,comedy
242,12.835999999999999,7.2,4313,40000000,162498338,122498338,drama
243,15.677,6.2,3181,90000000,0,-90000000,action
244,4.749,6.0,57,11000000,229653,-10770347,crime
245,13.645999999999999,5.9,814,35000000,34480045,-519955,crime
246,5.481,5.4,17,15000000,3471,-14996529,action
247,0.9159999999999999,6.0,1,11000000,62076141,51076141,drama
248,1.636,6.7,15,12000000,450594,-11549406,comedy
249,2.157,6.8,53,1900000,478595,-1421405,horror
250,0.84,2.0,1,13000000,17856688,4856688,action
251,7.109,4.2,79,10000000,2529395,-7470605,comedy
252,17.574,5.4,681,55000000,22597969,-32402031,action
253,5.877000000000001,7.2,93,2100000,1381824,-718176,documentary
254,43.078,6.5,2425,102000000,465195589,363195589,action
255,10.888,6.6,1487,1987650,21270290,19282640,thriller
256,8.676,7.1,1195,55000000,90552675,35552675,drama
257,1.9580000000000002,7.1,14,225000,1109276,884276,thriller
258,12.761,6.4,1841,20000000,36773510,16773510,comedy
259,0.6,5.5,2,250000,0,-250000,documentary
260,0.632,5.0,1,180000,17503,-162497,documentary
261,6.471,5.4,306,20000000,3727746,-16272254,drama
262,8.503,5.8,112,13700000,11738256,-1961744,crime
263,7.419,4.6,215,1500000,30351664,28851664,horror
264,15.237,6.8,618,1000000,101053,-898947,drama
265,17.604,6.9,450,10000000,11752387,1752387,biography
266,39.137,7.4,14000,250000000,1140069413,890069413,action
267,25.808000000000003,6.9,12810,140000000,370569776,230569776,action
268,18.073,7.7,11034,170000000,714401889,544401889,action
269,15.482999999999999,7.6,3909,55000000,220648184,165648184,biography
270,18.31,6.0,587,38000000,126577874,88577874,action
271,0.6,1.5,2,2000000,2791973,791973,drama
272,0.6,5.5,4,4200000,313230,-3886770,drama
273,10.181000000000001,7.1,1478,25000000,38112154,13112154,comedy
274,13.095999999999998,7.4,1949,11800000,42843521,31043521,drama
275,13.686,5.9,2681,1800000,25878153,24078153,drama
276,23.498,5.9,4058,200000000,560155383,360155383,adventure
277,18.427,6.7,2596,175000000,383541369,208541369,adventure
278,7.691,5.2,154,6000000,8446952,2446952,comedy
279,9.432,6.1,149,12500000,2272186,-10227814,biography
280,10.544,4.9,273,85000000,113026383,28026383,action
281,7.694,6.0,206,10000000,7862131,-2137869,comedy
282,14.478,6.3,3133,50000000,217194805,167194805,action
283,13.548,6.1,673,15000000,7885048,-7114952,action
284,3.767,5.0,20,4000000,0,-4000000,action
285,24.52,6.7,4995,49000000,105002056,56002056,action
286,9.454,6.9,1398,44000000,48478084,4478084,drama
287,6.546,7.0,329,20000000,8300821,-11699179,biography
288,6.406000000000001,6.4,216,100000,59424,-40576,comedy
289,0.6,1.0,1,1500000,0,-1500000,action
290,0.639,10.0,1,1000000,0,-1000000,drama
291,14.658,5.0,842,1000000,42411721,41411721,horror
292,26.386,6.2,903,50000000,8004221,-41995779,crime
293,13.744000000000002,6.0,657,25000000,23190292,-1809708,action
294,8.807,5.9,940,13000000,11831131,-1168869,drama
295,3.793,5.4,29,2500000,0,-2500000,comedy
296,20.930999999999997,7.4,1280,75000000,197504758,122504758,adventure
297,12.556,6.7,3084,12000000,123681790,111681790,drama
298,7.692,6.1,150,10000000,7582196,-2417804,biography
299,29.055999999999997,6.7,4517,95000000,534551353,439551353,drama
300,2.5869999999999997,3.8,6,2000000,10024,-1989976,horror
301,2.86,6.9,45,900000,958978,58978,drama
302,6.537999999999999,6.8,82,25000000,28012862,3012862,fantasy
303,4.341,7.1,24,17500000,325491,-17174509,documentary
304,15.574000000000002,5.7,3714,125000000,493214888,368214888,action
305,6.604,5.2,87,3000000,0,-3000000,action
306,1.067,7.2,19,1500000,5396,-1494604,comedy
307,0.6,8.0,1,100000,0,-100000,comedy
308,14.681,6.8,4505,102000000,130673154,28673154,action
309,18.335,6.4,1679,78000000,274392649,196392649,adventure
310,25.961,8.2,8669,175000000,798008101,623008101,horror
311,4.408,4.2,36,8000000,0,-8000000,action
312,4.758,6.7,56,2000000,0,-2000000,comedy
313,12.857000000000001,7.2,3270,36000000,85309093,49309093,drama
314,9.035,5.6,331,29200000,5466698,-23733302,action
315,10.584000000000001,6.5,1371,40000000,72295262,32295262,action
316,8.964,7.3,130,700000,1110511,410511,comedy
317,5.348,7.3,76,3000000,32653000,29653000,family
318,1.9269999999999998,5.1,21,3000000,7445044,4445044,action
319,6.93,6.4,340,270000,830700,560700,biography
320,17.046,5.2,1024,20000000,79114085,59114085,action
321,12.809000000000001,7.1,1435,35000000,50363790,15363790,biography
322,10.151,6.5,707,80000000,142783718,62783718,horror
323,10.444,6.3,2128,60000000,137551594,77551594,action
324,12.357000000000001,6.2,1114,25000000,98406855,73406855,action
325,7.51,7.2,297,12500000,11826980,-673020,biography
326,11.414000000000001,5.8,452,5000000,143658,-4856342,crime
327,8.82,5.4,796,37000000,55909910,18909910,action
328,0.6,6.7,3,20000000,32051917,12051917,comedy
329,8.016,6.0,215,10000000,2179623,-7820377,drama
330,0.6,8.3,3,50000,8374,-41626,documentary
331,7.567,6.3,126,15000000,20601987,5601987,drama
332,7.406000000000001,7.0,128,2000000,35185884,33185884,drama
333,1.9369999999999998,5.6,18,17000000,0,-17000000,drama
334,17.969,7.1,1496,30000000,238099711,208099711,comedy
335,3.35,5.6,36,1000000,63014,-936986,drama
336,5.121,4.1,23,3000000,331000,-2669000,biography
337,16.355999999999998,7.3,4010,37000000,173567581,136567581,drama
338,26.906999999999996,6.7,2236,50000000,213591522,163591522,drama
339,13.651,5.9,897,31500000,38771262,7271262,action
340,7.914,5.9,166,7000000,386744,-6613256,crime
341,9.897,6.5,2986,55000000,74966854,19966854,drama
342,0.6,4.0,1,500000,0,-500000,documentary
343,1.755,4.9,18,1200000,0,-1200000,horror
344,0.84,2.0,1,250000,8969065,8719065,biography
345,0.63,7.0,1,35000000,25114901,-9885099,drama
346,7.735,6.0,201,7000000,10062896,3062896,comedy
347,2.6069999999999998,4.6,33,1250000,0,-1250000,comedy
348,12.389000000000001,7.9,4961,5000000,60611845,55611845,biography
349,6.625,5.5,103,3000000,1324299,-1675701,comedy
350,10.022,8.1,358,9500000,294654618,285154618,action
351,3.035,6.2,22,14000000,34700000,20700000,drama
352,8.933,6.7,260,10000000,8465845,-1534155,biography
353,15.75,5.9,4197,150000000,238202668,88202668,comedy
354,11.582,6.1,1004,3500000,27704111,24204111,horror
355,15.331,7.3,2715,30000000,150807172,120807172,biography
356,4.656000000000001,5.0,46,12000000,1200346,-10799654,comedy
357,12.498,6.0,1743,55000000,152269033,97269033,comedy
358,1.4,2.0,1,75000,8799,-66201,drama
359,27.641,7.3,7080,170000000,710644566,540644566,action
360,1.7719999999999998,5.1,15,3500000,0,-3500000,drama
361,1.4,4.2,3,80000000,158908290,78908290,crime
362,10.349,6.0,866,30000000,19599974,-10400026,action
363,9.491,5.9,357,6000000,1673635,-4326365,crime
364,1.4,5.5,4,1800000,0,-1800000,mystery
365,35.067,7.6,20175,58000000,801025593,743025593,action
366,38.894,7.5,8773,110000000,786680557,676680557,action
367,12.048,6.8,2676,25000000,142033509,117033509,drama
368,7.455,6.1,296,1250000,5403771,4153771,comedy
369,6.862,5.7,439,21000000,48977233,27977233,comedy
370,18.014,5.9,1207,30000000,48575965,18575965,action
371,1.0759999999999998,7.1,18,500000,152449,-347551,documentary
372,13.685,6.7,2606,156000000,122603824,-33396176,action
373,11.283,6.1,1104,30000000,87956618,57956618,horror
374,7.962000000000001,6.2,858,22000000,70536870,48536870,comedy
375,6.84,5.1,267,3000000,4668109,1668109,horror
376,22.738000000000003,6.6,1244,30000000,80131391,50131391,action
377,9.267000000000001,6.7,349,10000000,9263940,-736060,biography
378,0.885,10.0,1,1100000,27561,-1072439,drama
379,7.814,6.2,500,22000000,57520063,35520063,action
380,1.508,6.9,33,4000000,596335,-3403665,biography
381,23.673000000000002,7.2,10057,69000000,543464573,474464573,animation
382,19.014,6.9,7319,76000000,975216835,899216835,adventure
383,16.407,6.3,4106,75000000,1034727750,959727750,adventure
384,17.815,5.9,176,9000000,3681096,-5318904,action
385,6.136,5.6,206,10000000,0,-10000000,horror
386,4.268,5.0,50,500000,1778,-498222,action
387,10.203,5.9,1516,10000000,63354114,53354114,drama
388,5.893,4.5,303,7000000,36146087,29146087,horror
389,6.797999999999999,5.9,136,24000000,11723620,-12276380,action
390,0.7759999999999999,2.4,4,500000,0,-500000,action
391,3.5210000000000004,7.5,4,2660000,0,-2660000,drama
392,12.255999999999998,6.0,736,15000000,76954311,61954311,comedy
393,11.36,6.2,440,22000000,77229695,55229695,comedy
394,8.961,6.4,492,18000000,73695194,55695194,comedy
395,10.839,5.6,193,22000000,35609577,13609577,comedy
396,6.632000000000001,5.6,920,69000000,86796502,17796502,comedy
397,11.432,5.8,2667,11500000,105078449,93578449,comedy
398,16.982,6.9,8279,85000000,276014965,191014965,action
399,21.26,8.0,15725,100000000,449948323,349948323,drama
400,5.599,7.0,72,2300000,14304931,12004931,drama
401,0.84,3.2,3,1000000,0,-1000000,western
402,33.035,7.3,12582,165000000,676404566,511404566,action
403,10.679,6.8,327,37000000,96068724,59068724,drama
404,7.403,6.7,173,36000000,57824533,21824533,drama
405,7.254,5.8,302,7000000,1857458,-5142542,comedy
406,12.78,5.9,2709,5500000,41268579,35768579,comedy
407,8.405,5.5,550,25000000,39126427,14126427,fantasy
408,9.246,7.2,954,7000000,18190831,11190831,comedy
409,2.6210000000000004,4.3,9,50000,0,-50000,crime
410,10.682,5.1,1887,68000000,54462971,-13537029,drama
411,29.043000000000003,6.2,3719,70000000,220241723,150241723,action
412,10.581,6.6,460,25000000,29847480,4847480,drama
413,6.867999999999999,7.4,721,8500000,122747755,114247755,action
414,0.664,3.0,2,60000000,30063805,-29936195,action
415,1.155,4.5,2,18000000,6000000,-12000000,documentary
416,9.047,6.0,670,50000000,41642166,-8357834,drama
417,1.4,5.2,5,68000000,75685268,7685268,crime
418,13.222999999999999,6.7,2788,45000000,41467606,-3532394,action
419,8.997,6.0,528,500000,407100,-92900,comedy
420,15.875,7.5,6737,15000000,81357930,66357930,documentary
421,14.095999999999998,5.3,959,50000000,41042583,-8957417,action
422,6.957000000000001,4.0,94,12000000,0,-12000000,action
423,0.6,6.7,5,7500000,106593296,99093296,comedy
424,2.873,4.9,18,500000,0,-500000,comedy
425,1.4,3.9,15,600000,3301,-596699,comedy
426,0.6,6.0,1,22000,0,-22000,comedy
427,12.445,6.3,2973,65000000,211739043,146739043,adventure
428,1.4909999999999999,5.4,16,5200000,11633427,6433427,action
429,15.964,5.5,1842,40000000,156553592,116553592,adventure
430,24.358,7.4,9156,150000000,499837368,349837368,action
431,0.956,0.8,2,20000000,0,-20000000,animation
432,9.064,4.6,174,5000000,74639,-4925361,drama
433,7.507999999999999,4.4,243,20000000,6093725,-13906275,action
434,1.392,5.3,6,1800000,0,-1800000,comedy
435,16.675,5.9,338,50000000,45285890,-4714110,adventure
436,7.189,5.7,377,13000000,42174545,29174545,adventure
437,14.69,6.8,4168,8000000,76200721,68200721,comedy
438,9.991,6.0,1208,60000000,206598789,146598789,drama
439,0.907,4.5,2,100000,0,-100000,action
440,11.482999999999999,7.2,1190,23000000,45060480,22060480,biography
441,2.5860000000000003,6.2,33,1400000,1632,-1398368,comedy
442,6.877000000000001,6.8,100,2300000,0,-2300000,drama
443,11.252,6.3,794,60000000,82812456,22812456,crime
444,19.753,7.6,8047,178000000,370541256,192541256,action
445,14.777000000000001,7.4,519,2000000,14341016,12341016,comedy
446,5.274,9.0,1,8000000,700261,-7299739,drama
447,0.6,8.0,1,65000000,56824633,-8175367,drama
448,6.2410000000000005,6.2,48,10000000,197901,-9802099,comedy
449,17.663,6.4,5406,120000000,286192091,166192091,drama
450,0.6,7.0,1,27000,3547,-23453,drama
451,0.6,6.0,2,5900000,37831658,31931658,drama
452,13.152000000000001,7.3,1770,15000000,57586606,42586606,action
453,15.533,6.6,3558,110000000,127983283,17983283,action
454,8.776,6.8,990,20000000,34718173,14718173,drama
455,0.7190000000000001,8.7,3,38000000,50970660,12970660,drama
456,8.722000000000001,6.7,464,8000000,25621449,17621449,comedy
457,6.899,6.7,83,500000,0,-500000,mystery
458,2.645,4.8,14,3000000,0,-3000000,thriller
459,13.802,6.2,647,30000000,46438538,16438538,comedy
460,13.995,6.4,1670,100000000,262794441,162794441,adventure
461,9.227,5.8,459,40000000,74156610,34156610,adventure
462,5.742999999999999,4.8,117,650000,171962,-478038,drama
463,17.88,6.7,2799,70000000,103735965,33735965,action
464,15.924000000000001,6.3,476,17000000,3917679,-13082321,crime
465,19.9,6.7,2874,65000000,221297061,156297061,action
466,0.633,6.0,1,20000000,9208876,-10791124,drama
467,7.492999999999999,6.0,301,5000000,2821010,-2178990,comedy
468,13.998,7.2,2447,10000000,61603136,51603136,drama
469,13.089,6.4,2664,17000000,97778356,80778356,fantasy
470,4.208,6.3,73,80000000,98341932,18341932,drama
471,18.485,7.6,8026,13000000,38358392,25358392,drama
472,5.934,4.7,121,25000,489792,464792,horror
473,26.789,5.7,2909,140000000,268314513,128314513,action
474,6.3,6.3,153,31000000,15826984,-15173016,drama
475,10.219,7.1,850,13000000,35402802,22402802,drama
476,10.003,7.1,142,5000000,6653715,1653715,documentary
477,11.624,6.6,384,50000000,26097497,-23902503,biography
478,0.6,4.2,3,550000,9111,-540889,biography
479,10.059,5.8,126,4500000,11774,-4488226,action
480,28.563000000000002,7.4,12152,180000000,802402853,622402853,adventure
481,48.508,6.9,4870,200000000,652220086,452220086,adventure
482,16.36,4.4,3837,87500000,333132750,245632750,action
483,2.097,7.2,4294,125000000,630163454,505163454,action
484,14.172,6.2,895,24000000,35792945,11792945,action
485,3.3560000000000003,7.2,69,2600000,0,-2600000,documentary
486,12.45,5.8,277,25000000,21038441,-3961559,adventure
487,3.1860000000000004,5.9,37,85000000,35681080,-49318920,drama
488,5.861000000000001,4.2,63,1000000,0,-1000000,horror
489,7.51,8.0,578,3200000,690872,-2509128,horror
490,12.753,6.8,1465,24000000,64282881,40282881,drama
491,19.479,7.1,1425,111000000,289847930,178847930,adventure
492,12.083,6.1,4489,55000000,381398492,326398492,drama
493,22.511999999999997,6.1,3535,55000000,371350619,316350619,drama
494,8.783999999999999,4.4,677,5000000,22113075,17113075,comedy
495,21.229,5.4,6451,40000000,570998101,530998101,drama
496,0.6,5.2,3,500000,0,-500000,action
497,2.199,3.5,14,20000000,0,-20000000,action
498,1.31,6.5,10,1250000,2940411,1690411,drama
499,13.392000000000001,6.0,1701,40000000,155011165,115011165,horror
500,15.392999999999999,7.0,7845,200000000,1021215193,821215193,adventure
501,22.958000000000002,7.1,2304,60000000,105203825,45203825,documentary
502,12.943,6.9,446,3500000,3874772,374772,drama
503,9.808,6.0,708,25000000,40286416,15286416,comedy
504,9.844,5.7,1249,26000000,61308153,35308153,drama
505,11.692,6.7,3582,31000000,160558438,129558438,drama
506,9.781,7.4,859,14000000,4289993,-9710007,comedy
507,8.453,6.7,849,29000000,56000339,27000339,biography
508,10.704,6.8,4173,65000000,168065700,103065700,comedy
509,4.705,2.1,46,45000000,73706,-44926294,action
510,10.269,6.6,929,24000000,62989834,38989834,comedy
511,2.858,6.8,33,21000000,38017873,17017873,drama
512,4.519,6.6,63,12000000,10026255,-1973745,drama
513,0.6,5.3,3,40000,0,-40000,comedy
514,15.953,7.4,406,3500000,16376066,12876066,drama
515,1.262,3.7,15,18000000,0,-18000000,drama
516,0.669,6.3,2,3000000,78948,-2921052,drama
517,4.738,5.4,21,12000000,46730578,34730578,documentary
518,9.968,7.0,621,3750000,2436111,-1313889,comedy
519,9.42,7.4,624,3000000,11262769,8262769,comedy
520,3.989,5.8,51,45000000,112006296,67006296,horror
521,14.627,6.8,1685,39000000,81150788,42150788,animation
522,5.705,6.6,57,2900000,172867,-2727133,documentary
523,9.31,5.8,231,33000000,70958,-32929042,comedy
524,4.476,5.1,28,6000000,0,-6000000,comedy
525,11.062000000000001,5.8,410,55000000,110387072,55387072,adventure
526,12.116,6.3,540,10000000,3793739,-6206261,action
527,8.574,6.6,787,50000000,23237252,-26762748,action
528,7.313,7.3,360,7000000,1732228,-5267772,biography
529,2.9619999999999997,3.9,9,3500000,12600000,9100000,thriller
530,8.833,7.1,791,31000000,68079671,37079671,sci-fi
531,9.149,5.5,777,9900000,11310835,1410835,horror
532,14.019,6.6,4637,35000000,146595891,111595891,comedy
533,12.078,6.0,1024,30000000,40520649,10520649,comedy
534,12.862,6.2,1075,52000000,53139168,1139168,action
535,9.722999999999999,6.3,80,2300000,59696,-2240304,crime
536,9.677999999999999,5.8,987,150000000,1272469910,1122469910,adventure
537,9.587,7.4,645,900000,17549645,16649645,biography
538,7.072,5.5,249,14000000,11166615,-2833385,adventure
539,20.396,7.3,6538,190000000,1518722794,1328722794,action
540,9.45,4.6,283,35000000,39340177,4340177,comedy
541,29.116999999999997,7.4,6653,80000000,210315681,130315681,action
542,15.065,5.5,3883,140000000,375740705,235740705,action
543,19.459,6.9,2756,37000000,117378084,80378084,action
544,13.029000000000002,6.3,2527,60000000,104100903,44100903,action
545,9.417,6.5,391,17000000,7265283,-9734717,action
546,13.652999999999999,5.8,2246,100000000,220796009,120796009,action
547,12.129000000000001,6.0,1469,40000000,106511453,66511453,comedy
548,8.485,5.9,980,40000000,91455875,51455875,adventure
549,6.287999999999999,6.7,251,30000000,33339868,3339868,biography
550,0.8340000000000001,5.5,8,5000000,255367951,250367951,horror
551,10.793,5.1,380,18000000,11813989,-6186011,thriller
552,2.832,5.7,23,22000000,517600000,495600000,horror
553,21.308000000000003,6.0,5128,110000000,167910690,57910690,action
554,18.678,4.8,2039,57000000,149217355,92217355,action
555,16.079,5.4,3780,30000000,295212467,265212467,action
556,16.745,7.9,2035,7000000,36964656,29964656,documentary
557,5.405,3.5,20,500000,0,-500000,comedy
558,8.589,6.8,968,28000000,140886353,112886353,comedy
559,0.6,2.0,1,250000,0,-250000,documentary
560,5.925,6.5,83,30000000,4967493,-25032507,comedy
561,2.352,6.0,10,2450000,182358,-2267642,drama
562,18.517,5.4,2353,140000000,138836756,-1163244,action
563,24.982,6.1,5053,160000000,529076069,369076069,action
564,11.25,6.6,1324,24000000,78672579,54672579,comedy
565,8.281,6.0,394,32000000,43603990,11603990,comedy
566,31.215,7.9,10459,61000000,368567189,307567189,drama
567,1.179,5.1,7,10000000,0,-10000000,drama
568,18.957,6.2,2147,58000000,158905324,100905324,adventure
569,20.238,5.6,428,35000000,93291478,58291478,adventure
570,10.033999999999999,5.2,231,10000000,6089100,-3910900,biography
571,7.117000000000001,6.1,202,5300000,440821,-4859179,comedy
572,1.547,10.0,1,5000000,8297,-4991703,comedy
573,6.058,6.0,352,30000000,25199891,-4800109,biography
574,1.9569999999999999,6.3,38,1700000,2507159,807159,drama
575,0.6,5.0,1,250000,23894000,23644000,thriller
576,8.475,6.2,700,2000000,2151887,151887,horror
577,27.836,7.2,9586,110000000,693698673,583698673,drama
578,1.891,7.3,37,9000000,2000093,-6999907,biography
579,36.284,8.3,3499,23000000,322034439,299034439,biography
580,17.257,5.1,4290,200000000,219535492,19535492,action
581,9.943,6.8,1314,5000000,3807503,-1192497,horror
582,11.519,6.4,1176,100000000,97523020,-2476980,action
583,3.5189999999999997,6.0,44,2900000,25935,-2874065,comedy
584,1.9809999999999999,7.0,16,2000000,35312,-1964688,comedy
585,14.290999999999999,6.1,3171,75000000,272223430,197223430,comedy
586,11.289000000000001,5.9,2090,80000000,247023808,167023808,comedy
587,7.917999999999999,6.0,711,40000000,69807260,29807260,comedy
588,49.606,7.9,17958,170000000,770867516,600867516,action
589,10.767999999999999,5.1,1282,112000000,232017848,120017848,adventure
590,9.329,4.8,68,10000000,1638202,-8361798,action
591,2.157,6.3,8,200000,0,-200000,drama
592,24.074,8.1,6608,40000000,168904682,128904682,biography
593,12.312000000000001,5.9,2328,22000000,64160680,42160680,comedy
594,9.984,5.5,1009,68000000,87173475,19173475,comedy
595,20.839000000000002,6.4,2020,15000000,77514401,62514401,horror
596,8.17,6.1,167,20000000,5031975,-14968025,action
597,9.709,6.6,1944,30000000,65343694,35343694,action
598,15.982000000000001,5.9,4548,50000000,214949716,164949716,action
599,0.6,7.0,3,3000000,5746453,2746453,documentary
600,0.6,6.0,2,35000,0,-35000,drama
601,5.767,5.1,95,70000,30312,-39688,comedy
602,21.23,6.6,3211,5000000,125010260,120010260,horror
603,8.131,5.9,754,135000000,157956466,22956466,adventure
604,2.309,6.7,25,250000,67665,-182335,documentary
605,10.459000000000001,6.2,1294,2000000,17187434,15187434,action
606,1.186,5.0,7,1000000,96734,-903266,action
607,2.9139999999999997,4.6,10,60000,0,-60000,crime
608,10.015,5.6,747,23000000,36374700,13374700,action
609,13.200999999999999,7.4,87,2000000,2420962,420962,comedy
610,9.718,6.2,363,12000000,100916299,88916299,biography
611,0.6,5.0,1,35000000,28906817,-6093183,action
612,3.01,6.4,46,1000000,552614,-447386,crime
613,12.955,5.5,273,5500000,18119231,12619231,horror
614,15.749,7.3,2468,12000000,37584304,25584304,action
615,7.8020000000000005,6.4,265,1000000,14662703,13662703,comedy
616,0.6,4.7,3,5000000,0,-5000000,animation
617,15.968,7.9,7776,23000000,48163815,25163815,drama
618,0.6,5.0,2,35000,0,-35000,horror
619,23.921999999999997,5.6,2606,70000000,250700000,180700000,action
620,10.265,6.0,812,42000000,73239258,31239258,action
621,7.886,5.9,848,50000000,108660270,58660270,drama
622,26.185,7.0,2491,10000000,70133905,60133905,drama
623,1.4,6.7,12,42000000,66787173,24787173,action
624,7.14,7.0,335,7000000,382946,-6617054,comedy
625,2.222,7.8,46,1000000,0,-1000000,drama
626,14.751,8.0,4710,25000000,231771716,206771716,biography
627,2.228,4.8,15,25000000,123696741,98696741,comedy
628,3.38,5.6,38,546173,0,-546173,comedy
629,5.7620000000000005,5.8,68,10000000,248133,-9751867,comedy
630,4.545,5.9,21,1800000,842693,-957307,drama
631,7.544,4.9,43,500000,528,-499472,action
632,2.4090000000000003,2.7,3,2000000,0,-2000000,drama
633,7.48,5.7,312,22000000,17216955,-4783045,action
634,14.082,5.6,1764,35000000,82182803,47182803,action
635,5.5120000000000005,5.0,36,1000000,15156,-984844,comedy
636,8.844,5.9,300,3000000,834953,-2165047,action
637,19.331,4.1,217,42000000,41926605,-73395,adventure
638,5.31,7.0,431,4000000,4230426,230426,drama
639,0.6,4.0,1,130000000,385997896,255997896,documentary
640,10.478,5.9,659,15000000,37336874,22336874,drama
641,0.6,5.8,6,400000,89134,-310866,documentary
642,3.843,6.3,33,1200000,2859955,1659955,drama
643,14.422,6.5,1410,22000000,51695362,29695362,action
644,2.2880000000000003,7.1,39,18000000,62646763,44646763,drama
645,14.738,5.6,611,63000000,188657593,125657593,adventure
646,8.312999999999999,6.1,429,30000000,133085295,103085295,comedy
647,14.058,6.5,3842,35000000,212417601,177417601,comedy
648,18.421,6.2,2581,40000000,105945357,65945357,comedy
649,0.6,5.5,2,250000,0,-250000,family
650,0.687,3.8,3,75000000,77636443,2636443,thriller
651,9.607000000000001,5.6,1000,35000000,45671512,10671512,action
652,10.15,6.0,1383,36000000,65967750,29967750,comedy
653,8.052999999999999,5.1,512,14000000,12826644,-1173356,comedy
654,14.585,5.9,471,15000000,12758799,-2241201,action
655,15.318,6.9,5013,85000000,378505812,293505812,animation
656,16.553,6.7,3184,80000000,469500298,389500298,animation
657,26.815,6.8,1673,65000000,527079962,462079962,adventure
658,1.4,8.0,1,1400000,0,-1400000,horror
659,8.72,5.8,1033,6900000,44103982,37203982,drama
660,8.455,6.6,505,1500000,236863,-1263137,comedy
661,11.0,6.3,197,10000000,62556228,52556228,comedy
662,10.270999999999999,6.1,2036,37000000,100003780,63003780,comedy
663,28.734,7.7,7610,165000000,494870992,329870992,action
664,27.105999999999998,7.7,5589,145000000,614586270,469586270,action
665,12.936,7.1,4124,180000000,180047784,47784,documentary
666,12.545,7.8,915,2500000,23845533,21345533,adventure
667,0.6,6.0,1,1000000,0,-1000000,drama
668,7.026,8.1,196,1000000,9617402,8617402,documentary
669,11.555,6.0,2805,50000000,146195159,96195159,action
670,9.558,4.9,296,18000000,309608,-17690392,action
671,9.7,7.6,155,7000000,85604221,78604221,biography
672,8.271,5.2,231,24000000,24474463,474463,comedy
673,16.298,6.4,1088,32000000,91553797,59553797,comedy
674,8.459,7.6,1814,1000000,852399,-147601,drama
675,13.102,6.3,977,1750000,1278471,-471529,horror
676,0.7440000000000001,4.2,5,400000,433588,33588,documentary
677,12.7,5.2,1090,65000000,74575290,9575290,action
678,15.407,7.5,2904,11000000,53797409,42797409,biography
679,5.002,5.2,42,6000000,0,-6000000,documentary
680,18.233,5.9,2430,105000000,402156682,297156682,adventure
681,17.537,6.3,4598,95000000,879765137,784765137,adventure
682,7.568,7.3,455,2600000,15298355,12698355,drama
683,0.6,6.3,3,28000000,82183683,54183683,crime
684,13.552999999999999,5.8,2230,35000000,175361578,140361578,adventure
685,13.579,7.2,388,12000000,19859167,7859167,drama
686,12.047,7.4,2703,11000000,78356170,67356170,drama
687,14.774000000000001,5.8,1431,75000000,211562435,136562435,action
688,7.646,5.9,67,15000000,214182,-14785818,drama
689,14.33,6.6,2137,100000000,89693309,-10306691,action
690,5.099,6.1,83,13000000,509193,-12490807,drama
691,18.912,6.8,6245,35000000,165103952,130103952,action
692,7.1370000000000005,5.2,314,5000000,9371036,4371036,horror
693,8.972999999999999,8.1,1034,6800000,16038343,9238343,drama
694,27.92,8.3,22186,160000000,835524642,675524642,action
695,36.286,7.6,6354,200000000,1242520711,1042520711,action
696,15.732000000000001,5.1,3911,165000000,384169424,219169424,action
697,3.562,4.2,35,1800000,0,-1800000,action
698,6.202000000000001,7.8,259,100000,0,-100000,documentary
699,5.599,5.4,13,2700000,3588305,888305,documentary
700,6.122000000000001,5.2,27,4000000,4327,-3995673,action
701,2.168,2.4,8,2100000,0,-2100000,action
702,17.41,5.9,3877,75000000,219519367,144519367,drama
703,14.244000000000002,6.6,1359,20000000,14772346,-5227654,comedy
704,9.514,7.8,466,2000000,7799257,5799257,crime
705,10.549000000000001,7.2,1400,11000000,32943247,21943247,drama
706,4.758,4.4,18,175000000,854235992,679235992,crime
707,16.197,6.9,3582,1500000,99870886,98370886,horror
708,16.017,6.1,1306,10000000,167885588,157885588,horror
709,0.6,10.0,1,46000000,113622499,67622499,drama
710,22.634,7.6,782,48000000,119736188,71736188,comedy
711,28.44,8.2,18597,165000000,666379375,501379375,adventure
712,7.132999999999999,5.3,121,10000000,0,-10000000,action
713,8.884,5.8,1169,50000000,150429371,100429371,documentary
714,13.725999999999999,5.7,2880,56200000,213116401,156916401,thriller
715,5.445,7.6,71,5500000,5580479,80479,biography
716,28.515,6.8,12368,170000000,621156389,451156389,action
717,32.093,6.9,14155,200000000,1215392272,1015392272,action
718,10.202,6.1,373,25000000,5297411,-19702589,action
719,13.966,7.2,10931,35000000,697457969,662457969,horror
720,12.337,5.8,1141,5000000,19720203,14720203,horror
721,18.419,6.5,3485,2000000,23250755,21250755,horror
722,1.3319999999999999,4.6,12,10000000,1642939,-8357061,comedy
723,10.01,7.0,1324,8000000,6632950,-1367050,comedy
724,8.628,6.2,1303,35000000,84606030,49606030,biography
725,7.7010000000000005,6.9,107,9200000,5806666,-3393334,drama
726,11.277000000000001,4.1,1124,79000000,150519217,71519217,comedy
727,18.312,6.4,4155,60000000,217370736,157370736,action
728,17.085,5.6,2831,60000000,159946489,99946489,action
729,11.061,6.1,1687,60000000,131377412,71377412,action
730,12.773,5.6,3403,195000000,197687603,2687603,adventure
731,10.715,6.3,655,20000000,171685793,151685793,action
732,8.818999999999999,6.4,1420,9000000,36588512,27588512,biography
733,2.864,6.1,18,400000,44452,-355548,comedy
734,8.825,5.5,439,25000000,3771345,-21228655,action
735,14.568,6.1,3611,120000000,416168316,296168316,action
736,8.821,6.2,320,10000000,4708127,-5291873,comedy
737,7.942,5.4,241,5000000,2368937,-2631063,adventure
738,6.933,6.9,380,40000000,65282732,25282732,biography
739,17.398,6.1,1887,10000000,102445196,92445196,crime
740,6.461,5.5,96,5000000,927074,-4072926,biography
741,8.023,6.1,1622,18000000,43402515,25402515,biography
742,8.57,6.6,514,4000000,373375,-3626625,drama
743,18.549,6.1,3338,275000000,282778100,7778100,action
744,78.123,7.2,10081,30000000,76235001,46235001,action
745,15.542,6.1,1810,45000000,164640401,119640401,action
746,13.467,4.6,708,47000000,11022696,-35977304,action
747,14.454,5.9,2152,79000000,318146162,239146162,action
748,10.305,6.5,2723,60000000,101134059,41134059,drama
749,6.787000000000001,6.4,70,27500000,31157914,3657914,comedy
750,0.627,2.0,1,6000000,1365108,-4634892,horror
751,20.395,6.7,7213,90000000,964496193,874496193,action
752,8.477,6.0,103,7000000,38158601,31158601,comedy
753,24.058000000000003,5.3,4401,179000000,181982519,2982519,action
754,20.709,6.6,14056,215000000,1648854864,1433854864,action
755,34.958,6.5,5995,170000000,1305772799,1135772799,action
756,8.459,4.9,94,22000000,6756412,-15243588,action
757,19.565,6.4,2958,80000000,214974953,134974953,comedy
758,7.047000000000001,6.2,211,12000000,21867665,9867665,comedy
759,34.953,6.2,7510,300000000,655945209,355945209,action
760,8.602,5.1,240,13000000,99034125,86034125,documentary
761,7.138999999999999,6.8,147,12000000,32700439,20700439,documentary
762,8.952,6.0,644,15000000,20688141,5688141,action
763,6.558,7.4,76,750000,7712436,6962436,comedy
764,8.476,6.9,142,2500000,32327255,29827255,comedy
765,7.7860000000000005,6.5,159,10000000,23591043,13591043,comedy
766,1.824,4.7,16,5600000,14683763,9083763,action
767,9.597000000000001,5.6,129,15000000,20898221,5898221,adventure
768,13.08,7.1,7540,28000000,97531134,69531134,action
769,14.793,6.4,3785,28000000,63129909,35129909,action
770,4.002,6.6,50,10000000,150191,-9849809,adventure
771,10.959000000000001,6.0,805,21000000,34836080,13836080,horror
772,7.0360000000000005,6.1,332,800000,462206,-337794,crime
773,7.13,6.9,274,12000000,1188194,-10811806,crime
774,10.062000000000001,6.6,507,5000000,6656705,1656705,biography
775,15.135,6.2,1093,70000000,65409046,-4590954,action
776,13.742,6.5,703,10000000,4659110,-5340890,crime
777,10.221,5.8,1314,75000000,95572749,20572749,action
778,11.298,6.0,1105,15000000,39238443,24238443,crime
779,23.805,6.2,289,30000000,10096821,-19903179,action
780,21.793000000000003,6.5,3305,175000000,139630336,-35369664,action
781,1.244,8.0,1,7000000,23393939,16393939,documentary
782,24.337,7.0,5531,104000000,408803696,304803696,action
783,26.103,7.6,10287,94000000,404561724,310561724,action
784,6.058,5.8,67,9200000,17155193,7955193,action
785,17.713,6.0,2494,117000000,258751370,141751370,action
786,17.867,5.0,1490,2000000,6328516,4328516,drama
787,29.388,6.3,6054,185000000,561072059,376072059,action
788,9.417,6.0,1046,15000000,61788393,46788393,comedy
789,5.287999999999999,6.8,86,30000,144822,114822,drama
790,13.847000000000001,7.7,2029,55000000,77548122,22548122,action
791,17.363,6.7,3628,150000000,664837547,514837547,action
792,16.248,6.7,2944,140000000,517599142,377599142,action
793,5.334,5.3,91,930000,30905,-899095,comedy
794,16.275,7.9,10028,20000000,426351163,406351163,comedy
795,9.258,6.9,546,18000000,14189810,-3810190,drama
796,15.974,7.3,3866,10000000,78610769,68610769,comedy
797,7.261,5.8,676,30000000,61449135,31449135,comedy
798,2.394,4.4,11,67000000,18115927,-48884073,comedy
799,6.5329999999999995,6.4,1211,28000000,112914167,84914167,comedy
800,12.147,7.0,1660,26000000,54393687,28393687,action
801,6.303999999999999,6.6,65,20000000,2507181,-17492819,biography
802,5.973,6.9,169,5500000,13480196,7980196,comedy
803,9.307,6.9,133,8000000,2455027,-5544973,adventure
804,2.563,5.6,30,19000000,32618920,13618920,comedy
805,13.897,4.0,713,18500000,4221341,-14278659,horror
806,10.195,6.8,1692,25000000,42425450,17425450,biography
807,10.754000000000001,6.6,1223,100000000,139716717,39716717,action
808,1.6269999999999998,7.5,4,26000000,67647574,41647574,action
809,0.675,7.0,2,20000000,28270399,8270399,drama
810,2.01,6.2,23,3000000,7241309,4241309,documentary
811,7.157,5.6,96,5000000,0,-5000000,comedy
812,4.242,6.9,71,3000000,3237452,237452,drama
813,9.394,6.9,1706,30000000,82148538,52148538,adventure
814,6.425,6.1,210,58000000,100929666,42929666,drama
815,11.806,6.8,1748,38000000,105887837,67887837,comedy
816,15.0,7.3,8723,120000000,620912003,500912003,adventure
817,13.696,6.2,435,30000000,65759911,35759911,comedy
818,12.408,6.3,2220,5000000,148806510,143806510,drama
819,10.091000000000001,6.5,638,250000,3728400,3478400,drama
820,0.6,7.7,3,8300000,2598224,-5701776,drama
821,19.453,7.1,6295,27000000,155564919,128564919,documentary
822,12.693,6.8,2261,65000000,273346281,208346281,biography
823,17.215999999999998,8.1,3833,12000000,149570720,137570720,comedy
824,5.805,7.0,292,20000000,17769299,-2230701,drama
825,12.152999999999999,5.6,1883,100000000,310650574,210650574,comedy
826,2.9189999999999996,6.8,11,15000000,50003303,35003303,drama
827,11.322000000000001,6.2,759,65000000,21774432,-43225568,action
828,9.128,6.9,1370,2000000,2088390,88390,drama
829,0.732,6.4,4,300000,3496,-296504,thriller
830,11.273,5.9,1004,20000000,33943049,13943049,action
831,45.0,7.8,12330,127000000,615461394,488461394,action
832,15.743,6.7,1627,29000000,44264271,15264271,comedy
833,12.43,6.1,1810,11000000,10431506,-568494,comedy
834,8.557,5.3,59,8000000,433732,-7566268,crime
835,15.287,5.9,2591,60000000,195194085,135194085,action
836,15.404000000000002,7.4,2289,40000000,149804632,109804632,action
837,5.034,7.2,39,40000000,43711031,3711031,biography
838,16.779,6.8,6723,30000000,170466405,140466405,action
839,7.029,5.8,352,2000000,2009644,9644,drama
840,7.699,5.7,92,17000000,24719879,7719879,comedy
841,0.6,5.0,2,500000,0,-500000,comedy
842,6.185,6.1,28,25000000,146149,-24853851,biography
843,8.261000000000001,5.8,384,18000000,42227490,24227490,comedy
844,15.607999999999999,8.2,3165,10000000,65520633,55520633,comedy
845,4.775,5.0,44,10100000,10143618,43618,comedy
846,8.506,6.7,529,9000000,12898064,3898064,biography
847,1.4,6.0,4,916000,6188421,5272421,adventure
848,0.628,4.0,1,2000000,0,-2000000,comedy
849,16.73,6.3,10019,40000000,457507776,417507776,action
850,7.666,5.3,270,10000000,8629895,-1370105,action
851,12.557,6.3,1862,12500000,46370970,33870970,action
852,10.36,5.5,1079,20000000,18273009,-1726991,action
853,9.12,6.5,477,30000000,3721988,-26278012,action
854,28.099,7.4,14454,150000000,370098020,220098020,action
855,18.705,6.5,3380,145000000,746921271,601921271,adventure
856,7.275,6.6,150,8000000,15644196,7644196,biography
857,9.392999999999999,6.7,71,25000000,54160818,29160818,comedy
858,13.0,5.3,958,4500000,1027760,-3472240,drama
859,13.7,6.1,1850,7000000,170549753,163549753,comedy
860,8.681000000000001,6.2,1110,14500000,123660597,109160597,comedy
861,19.274,7.0,8143,180000000,758536735,578536735,action
862,11.982999999999999,6.1,2421,15000000,148095566,133095566,documentary
863,27.666999999999998,6.5,9758,225000000,667999518,442999518,action
864,11.263,6.3,1460,42000000,49621440,7621440,action
865,16.637999999999998,7.5,3176,8500000,77733867,69233867,drama
866,8.262,6.9,319,35000000,29890402,-5109598,biography
867,16.24,6.2,618,6000000,1427656,-4572344,action
868,7.6610000000000005,5.4,94,4000000,797439,-3202561,drama
869,6.666,6.0,471,350000,10000000,9650000,action
870,8.747,6.3,138,14000000,623292,-13376708,drama
871,9.498,6.8,856,3400000,20433227,17033227,drama
872,8.487,5.1,367,50000000,89895930,39895930,comedy
873,8.852,5.7,299,150000000,39549758,-110450242,adventure
874,7.879,7.3,257,12000000,10116816,-1883184,biography
875,9.477,6.7,413,1000000,5438911,4438911,drama
876,30.419,6.6,1457,130000000,341528518,211528518,comedy
877,16.115,6.6,592,25000000,46734733,21734733,biography
878,7.766,6.8,407,20000000,43658157,23658157,biography
879,8.88,5.2,383,10000000,4563080,-5436920,action
880,17.31,6.6,6365,61000000,310566162,249566162,action
881,8.197000000000001,7.3,358,17000000,45707924,28707924,biography
882,8.677,7.6,1570,8000000,9266180,1266180,comedy
883,16.917,7.7,5939,20000000,208265198,188265198,drama
884,16.302,5.6,1929,40000000,109738840,69738840,action
885,7.309,6.5,113,2000000,1869928,-130072,drama
886,6.131,4.4,139,900000,9097072,8197072,comedy
887,0.6,5.4,7,2000000,6049171,4049171,documentary
888,22.855,6.8,3635,130000000,321887208,191887208,action
889,11.123,7.1,1642,9400000,21817298,12417298,documentary
890,26.176,6.4,6398,215000000,654213485,439213485,action
891,1.62,6.5,11,200000,236806,36806,drama
892,8.479,7.0,190,8500000,23311293,14811293,comedy
893,13.171,7.5,3965,30000000,162502774,132502774,comedy
894,8.652999999999999,6.3,1105,18000000,7680250,-10319750,action
895,11.675999999999998,6.0,1552,33000000,75898100,42898100,adventure
896,21.246,6.0,920,35000000,66295121,31295121,action
897,1.218,5.0,1,20000000,57293371,37293371,documentary
898,7.771,6.8,353,25000000,39217912,14217912,biography
899,9.338,6.4,7343,74000000,1160336173,1086336173,adventure
900,10.078,7.1,478,13000000,73798736,60798736,biography
901,13.220999999999998,5.8,2099,85000000,173613482,88613482,adventure
902,7.2989999999999995,5.5,301,11000000,2352511,-8647489,crime
903,10.128,6.3,50,15000000,15362298,362298,action
904,7.422999999999999,5.8,77,5500000,863895,-4636105,drama
905,12.215,7.4,912,18000000,7719630,-10280370,drama
906,1.96,6.5,16,150000000,637517365,487517365,adventure
907,1.4,5.8,5,21000000,17396,-20982604,action
908,11.095,8.3,1399,4900000,17536004,12636004,drama
909,11.134,6.4,1859,27000000,93466095,66466095,crime
910,15.392999999999999,7.1,2255,50000000,111300835,61300835,biography
911,0.6,5.0,1,5000000,64240813,59240813,action
912,8.827,5.9,414,125000000,61642798,-63357202,action
913,10.175,6.2,848,500000,5639730,5139730,horror
914,20.33,7.0,6362,200000000,743588329,543588329,adventure
915,11.017000000000001,6.2,1193,20000000,39686769,19686769,adventure
916,15.948,7.4,3893,1500000,65245512,63745512,drama
917,14.085999999999999,7.7,3023,16000000,68848446,52848446,adventure
918,1.057,4.7,5,1500000,372239,-1127761,drama
919,9.912,5.7,843,8000000,7298786,-701214,action
920,10.595,6.3,717,40000000,59795070,19795070,comedy
921,40.095,6.0,1751,100000000,85287417,-14712583,action
922,13.263,5.4,1666,60000000,30396134,-29603866,action
923,15.227,7.0,3458,30000000,42531076,12531076,drama
924,12.812999999999999,4.4,1332,10000000,31164747,21164747,comedy
925,12.812999999999999,6.6,1357,145000000,269806430,124806430,adventure
926,7.8839999999999995,6.5,301,14000000,25187026,11187026,biography
927,5.952000000000001,7.2,165,8000000,22549338,14549338,drama
928,12.507,7.0,1592,10000000,31556959,21556959,drama
929,9.118,6.2,473,55000000,79312301,24312301,adventure
930,15.937000000000001,6.7,5406,55000000,345922730,290922730,crime
931,7.459,8.0,755,1400000,5552584,4152584,drama
932,1.4,7.0,2,46000000,298923419,252923419,comedy
933,6.7139999999999995,5.8,593,18000000,92096558,74096558,comedy
934,4.378,5.9,68,1400000,0,-1400000,comedy
935,2.0069999999999997,5.8,5,1000000,0,-1000000,comedy
936,7.619,7.8,409,8470000,42355526,33885526,action
937,9.808,5.4,247,25000000,16727470,-8272530,horror
938,12.081,6.7,741,10000000,34240572,24240572,biography
939,1.1320000000000001,4.8,6,1600000,2595644,995644,crime
940,9.521,7.4,967,12000000,24761360,12761360,adventure
941,13.722999999999999,6.1,2389,66000000,194169619,128169619,action
942,14.979000000000001,6.2,4536,18000000,270944428,252944428,drama
943,17.662,5.7,2829,35000000,108757621,73757621,comedy
944,14.508,7.1,4590,20000000,70652284,50652284,drama
945,10.012,6.8,1294,15000000,11173718,-3826282,drama
946,1.973,5.4,7,9000,4584,-4416,comedy
947,20.064,6.1,3536,127000000,353756621,226756621,adventure
948,0.6,6.5,1,4200000,5835247,1635247,horror
949,12.786,6.0,775,29000000,103008792,74008792,documentary
950,25.596999999999998,7.7,5860,8500000,50334418,41834418,crime
951,0.637,9.0,1,80000000,53508858,-26491142,horror
952,8.882,5.1,125,2000000,0,-2000000,crime
953,19.005,6.8,1296,5000000,42844516,37844516,action
954,14.519,5.8,286,13200000,54323210,41123210,action
955,0.6,7.0,1,1000000,2684207,1684207,western
956,14.203,6.2,2612,25000000,149228078,124228078,comedy
957,0.6,7.6,11,130000000,352831065,222831065,animation
958,16.19,7.4,4192,22500000,32398681,9898681,drama
959,2.2640000000000002,5.6,23,50000000,222383055,172383055,action
960,9.325,4.2,192,18000000,30535660,12535660,adventure
961,2.246,4.2,50,800000,35688,-764312,comedy
962,4.48,5.2,64,2500000,0,-2500000,thriller
963,0.6,6.0,1,4000000,63180,-3936820,drama
964,2.519,7.6,38,250000,191862,-58138,documentary
965,16.646,7.4,9871,75000000,342769200,267769200,crime
966,25.805,6.8,6744,90000000,328325007,238325007,action
967,18.534000000000002,6.5,6850,120000000,287916633,167916633,action
968,8.232000000000001,6.7,256,1000000,3324070,2324070,comedy
969,4.835,6.8,56,1000000,5391992,4391992,drama
970,10.841,6.4,1747,5000000,44115496,39115496,horror
971,10.729000000000001,5.6,1191,45000000,91323299,46323299,comedy
972,11.378,5.9,1032,3000000,6239723,3239723,action
973,13.864,6.2,4086,70000000,172878928,102878928,action
974,32.624,7.4,225,20000000,38073377,18073377,biography
975,8.919,5.6,518,25000000,9313302,-15686698,drama
976,10.308,7.2,2105,15000000,59168692,44168692,drama
977,9.005,8.1,370,10000000,68541786,58541786,documentary
978,8.62,5.5,615,42000000,36197221,-5802779,action
979,10.196,5.8,1396,4800000,4494560,-305440,crime
980,14.163,7.0,603,38000000,24555177,-13444823,action
981,3.2710000000000004,5.1,20,3000000,47469,-2952531,action
982,0.6,7.0,1,100000,0,-100000,documentary
983,15.389000000000001,5.1,1670,5000000,103300632,98300632,horror
984,11.823,6.0,1416,9000000,81831866,72831866,drama
985,8.304,5.9,306,28000000,8594558,-19405442,comedy
986,5.025,5.5,57,14000000,21410546,7410546,comedy
987,8.523,6.1,527,5000000,25861249,20861249,comedy
988,0.6,10.0,1,4600000,731767,-3868233,comedy
989,7.143,4.8,79,1600000,419428,-1180572,horror
990,9.139,6.6,1077,22000000,15434375,-6565625,crime
991,19.477,6.3,535,12000000,85369830,73369830,comedy
992,13.377,5.8,4829,200000000,490359051,290359051,adventure
993,16.759,6.8,7632,190000000,411002906,221002906,action
994,30.019000000000002,5.9,2213,155000000,290930148,135930148,action
995,13.565,7.0,1904,55000000,258789097,203789097,adventure
996,16.509,6.1,2500,26000000,81275291,55275291,action
997,7.2620000000000005,6.4,528,1000000,1156309,156309,drama
998,13.054,5.9,1701,150000000,151525973,1525973,adventure
999,11.564,6.0,3587,12000000,85450484,73450484,comedy
1000,0.6,10.0,1,40000000,16340767,-23659233,drama
1001,8.163,5.7,1342,3000000,177512032,174512032,horror
1002,9.669,5.9,1197,5000000,207039844,202039844,horror
1003,8.965,5.4,1026,5000000,142817992,137817992,horror
1004,8.157,5.2,774,10000000,77959374,67959374,horror
1005,9.446,5.3,752,5000000,90904854,85904854,horror
1006,13.32,6.8,1358,60000000,108119662,48119662,adventure
1007,10.124,5.8,276,25000000,120832383,95832383,comedy
1008,14.95,5.8,1868,35000000,48543388,13543388,action
1009,6.056,6.1,206,10000000,1616353,-8383647,drama
1010,14.074000000000002,6.8,7869,110000000,302239672,192239672,drama
1011,9.486,7.1,736,5000000,10727536,5727536,comedy
1012,15.435,6.9,1337,40000000,52837989,12837989,action
1013,6.934,7.0,122,1000000,1471090,471090,drama
1014,15.234000000000002,6.5,3017,40000000,101162106,61162106,adventure
1015,15.940999999999999,5.0,900,38000000,107650646,69650646,action
1016,12.005,7.1,98,5000000,25529498,20529498,adventure
1017,0.84,5.0,1,50000000,161626121,111626121,action
1018,2.6510000000000002,5.2,34,11000000,9307166,-1692834,comedy
1019,20.899,6.4,2273,132000000,366942531,234942531,adventure
1020,9.078,6.8,360,16000000,12617472,-3382528,comedy
1021,32.476,6.5,716,25000000,51800758,26800758,action
1022,26.691,6.1,4229,95000000,223050874,128050874,adventure
1023,15.762,5.9,3109,90000000,200859554,110859554,adventure
1024,1.379,5.0,1,200000,0,-200000,drama
1025,15.974,6.5,650,50000000,347136477,297136477,adventure
1026,7.211,6.0,151,18000000,1199510,-16800490,drama
1027,8.978,7.4,945,12000000,98963392,86963392,biography
1028,1.4,6.8,6,1200000,26608,-1173392,documentary
1029,11.302,5.3,1029,24000000,83660160,59660160,comedy
1030,28.101,6.6,6931,230000000,788241137,558241137,action
1031,30.579,6.4,8571,410600000,1045663875,635063875,action
1032,13.886,7.3,4233,17000000,116044347,99044347,comedy
1033,18.469,6.8,3599,29000000,287625468,258625468,comedy
1034,14.89,6.5,1884,45000000,185736412,140736412,comedy
1035,23.029,5.6,4423,90000000,244041804,154041804,action
1036,7.815,6.1,116,10000000,575371,-9424629,action
1037,7.778,5.6,420,35000000,2000000,-33000000,comedy
1038,5.945,6.3,81,3000000,4570178,1570178,comedy
1039,0.6,7.5,1,2000000,28864,-1971136,drama
1040,6.021,6.6,230,3000000,0,-3000000,action
1041,9.435,5.6,1260,24000000,83531958,59531958,action
1042,7.682,7.8,670,8900000,22744132,13844132,crime
1043,17.343,5.1,1438,35000000,95713069,60713069,horror
1044,25.215,5.4,2078,80000000,108469033,28469033,action
1045,11.844000000000001,6.6,675,20000000,9537120,-10462880,comedy
1046,6.921,5.4,95,7500000,0,-7500000,crime
1047,15.865,6.2,2667,120000000,142531552,22531552,action
1048,16.215999999999998,6.1,1979,40000000,127234389,87234389,action
1049,12.484000000000002,6.2,1244,35000000,31393201,-3606799,action
1050,9.086,5.7,1195,28000000,16638300,-11361700,action
1051,15.318,5.5,1157,60000000,84154026,24154026,action
1052,14.357999999999999,8.0,5785,46000000,113402302,67402302,crime
1053,9.55,6.5,1449,12000000,32909437,20909437,drama
1054,9.715,6.4,2968,12000000,103028188,91028188,mystery
1055,6.9110000000000005,6.0,276,8000000,10763183,2763183,comedy
1056,24.98,6.4,7384,125000000,402448265,277448265,adventure
1057,8.702,6.2,378,15000000,12394562,-2605438,documentary
1058,9.371,5.5,259,30000000,21709539,-8290461,action
1059,0.779,7.4,6,2000000,72277,-1927723,documentary
1060,9.078,6.3,1422,130000000,554987477,424987477,action
1061,8.32,6.6,209,11000000,56178935,45178935,comedy
1062,1.252,3.2,5,75000,0,-75000,action
1063,7.564,7.1,225,15000000,10055481,-4944519,biography
1064,7.109,6.0,136,36000000,1578543,-34421457,adventure
1065,21.377,5.6,2047,130000000,79076678,-50923322,action
1066,9.389,6.8,292,5000000,6205034,1205034,documentary
1067,8.705,7.2,910,5000000,23745772,18745772,drama
1068,48.056999999999995,7.2,2626,175000000,524283695,349283695,adventure
1069,7.442,6.3,460,15000000,27469621,12469621,adventure
1070,24.238000000000003,6.2,3176,120000000,428056280,308056280,action
1071,14.462,6.6,3412,135000000,245724600,110724600,adventure
1072,8.48,5.4,123,12000000,2062406,-9937594,drama
1073,1.675,3.7,8,40000,3632,-36368,horror
1074,4.191,4.8,47,9500000,0,-9500000,action
1075,4.659,5.2,48,5000000,0,-5000000,comedy
1076,30.029,7.6,7021,150000000,579290136,429290136,action
1077,1.58,4.8,9,25000000,0,-25000000,biography
1078,14.811,6.8,4566,110000000,263880341,153880341,action
1079,0.914,3.4,7,45000000,17492014,-27507986,horror
1080,12.082,6.6,4162,60000000,196439693,136439693,thriller
1081,14.994000000000002,6.5,2368,84000000,141507355,57507355,action
1082,13.904000000000002,5.4,849,65000000,48164150,-16835850,action
1083,0.6,5.0,2,26000000,96666486,70666486,horror
1084,8.25,6.1,615,17700000,14518884,-3181116,drama
1085,11.856,5.9,1884,42000000,91678442,49678442,fantasy
1086,0.875,0.0,1,3000000,9012000,6012000,horror
1087,3.8789999999999996,4.5,33,25000000,91116,-24908884,action
1088,18.117,6.5,3406,69000000,145951861,76951861,action
1089,7.816,6.1,472,4000000,1983596,-2016404,action
1090,10.247,6.0,256,58000000,50365498,-7634502,action
1091,0.6659999999999999,3.8,2,23000000,13593473,-9406527,adventure
1092,1.128,4.7,6,2300000,29384,-2270616,drama
1093,10.713,5.5,1065,20000000,15824374,-4175626,crime
1094,7.621,6.8,87,14000000,11354230,-2645770,action
1095,11.453,7.1,2079,16000000,56506120,40506120,thriller
1096,12.437000000000001,6.2,976,32000000,18195238,-13804762,action
1097,0.667,5.9,2119,57500000,295874190,238374190,action
1098,1.325,5.7,2321,65000000,240647629,175647629,action
1099,0.8440000000000001,5.9,1859,40000000,314101190,274101190,action
1100,7.268,6.4,258,8000000,2772511,-5227489,drama
1101,1.661,4.7,21,18000000,4100000,-13900000,drama
1102,8.247,5.8,473,18000000,41166033,23166033,comedy
1103,17.434,6.2,2852,38000000,94763758,56763758,action
1104,10.831,6.2,1277,25000000,153733800,128733800,action
1105,12.977,6.2,939,40000000,124827316,84827316,action
1106,13.53,4.9,1785,25000000,82917283,57917283,drama
1107,14.695,6.6,3730,90000000,487519809,397519809,adventure
1108,18.11,6.3,1803,130000000,492846291,362846291,adventure
1109,14.934000000000001,7.3,3697,145000000,306900902,161900902,action
1110,22.995,7.2,7259,93000000,470986200,377986200,action
1111,10.089,5.8,433,20000000,46255763,26255763,action
1112,1.08,6.6,12,1500000,113169,-1386831,comedy
1113,0.746,4.2,5,500000,0,-500000,drama
1114,0.68,5.7,3,99000000,84747441,-14252559,action
1115,17.851,5.8,3390,120000000,242981799,122981799,action
1116,7.485,6.9,620,2500000,4934356,2434356,comedy
1117,10.362,5.7,123,60000000,24148488,-35851512,adventure
1118,11.369000000000002,6.1,686,70000000,61031932,-8968068,comedy
1119,5.202999999999999,5.5,154,15000000,3386153,-11613847,comedy
1120,1.115,7.0,4,2000000,0,-2000000,adventure
1121,0.809,5.1,6,500000,0,-500000,adventure
1122,21.401,7.5,9296,200000000,1049102856,849102856,action
1123,12.687999999999999,6.2,499,22000000,12967012,-9032988,crime
1124,2.0869999999999997,7.5,4,10000000,3275585,-6724415,biography
1125,20.0,8.1,5494,13000000,36262783,23262783,drama
1126,9.019,6.7,121,10000000,3185717,-6814283,biography
1127,1.247,4.3,4,350000,0,-350000,family
1128,14.338,5.6,1096,20000000,46844357,26844357,comedy
1129,8.318999999999999,5.9,417,500000,680914,180914,comedy
1130,8.03,7.4,149,5000000,567219,-4432781,comedy
1131,17.592,6.4,1684,50000000,66961644,16961644,action
1132,0.6,3.5,2,50000,0,-50000,horror
1133,10.442,5.6,761,30000000,60512680,30512680,crime
1134,14.623,7.7,3877,38000000,98230839,60230839,documentary
1135,4.11,6.8,19,250000,0,-250000,documentary
1136,14.055,5.5,779,35000000,18376443,-16623557,action
1137,15.622,6.3,1248,33000000,41495213,8495213,action
1138,9.095,7.1,1433,28000000,94050951,66050951,drama
1139,13.116,6.4,1997,85000000,208542162,123542162,horror
1140,9.214,6.9,792,750000,4422318,3672318,comedy
1141,0.632,1.0,1,130000000,290650494,160650494,action
1142,6.507000000000001,5.4,38,5500000,28468,-5471532,action
1143,8.756,6.8,103,6500000,6423605,-76395,biography
1144,6.015,8.2,276,4000000,5966671,1966671,documentary
1145,27.414,6.1,5125,110000000,456258539,346258539,action
1146,7.457000000000001,5.9,515,30000000,108957098,78957098,adventure
1147,15.232000000000001,5.6,4237,19000000,141344255,122344255,adventure
1148,7.504,6.3,1246,45000000,82513490,37513490,crime
1149,9.585,7.4,2050,35000000,114962525,79962525,biography
1150,14.383,7.3,3882,85000000,48056764,-36943236,action
1151,10.450999999999999,6.2,915,15000000,15554855,554855,action
1152,16.082,6.2,1610,40000000,95989590,55989590,horror
1153,1.945,5.0,6,12000000,6982680,-5017320,crime
1154,2.7460000000000004,7.4,12,5000000,16515203,11515203,documentary
1155,12.535,5.3,1352,40000000,91126600,51126600,action
1156,16.322,6.2,361,15700000,63288854,47588854,comedy
1157,6.892,6.3,696,20000000,32608019,12608019,crime
1158,9.059,7.0,200,35000000,60376247,25376247,biography
1159,8.092,6.4,1108,10000000,11766959,1766959,adventure
1160,19.131,6.3,1815,26000000,33667319,7667319,action
1161,9.541,7.5,1354,20000000,66776576,46776576,biography
1162,10.967,6.8,2109,13500000,33035736,19535736,comedy
1163,22.855999999999998,5.3,1549,95000000,108874967,13874967,action
1164,9.986,5.9,809,95000000,294680778,199680778,comedy
1165,20.429000000000002,5.3,2684,40000000,126069509,86069509,comedy
1166,6.107,6.4,9,25000000,3645957,-21354043,adventure
1167,1.4,6.5,2,6500000,20412841,13912841,drama
1168,6.824,6.1,80,50000000,15505922,-34494078,crime
1169,3.5210000000000004,3.9,31,2000000,0,-2000000,action
1170,7.879,5.0,245,25000000,18877153,-6122847,horror
1171,7.775,6.1,970,20000000,48680977,28680977,comedy
1172,12.987,5.4,343,59000000,87527651,28527651,adventure
1173,5.39,5.6,53,90000000,498438212,408438212,adventure
1174,18.301,7.1,6380,125000000,535663443,410663443,action
1175,15.040999999999999,6.1,3843,165000000,756244673,591244673,adventure
1176,10.535,5.2,374,10000000,11360665,1360665,drama
1177,0.6,6.0,1,8000000,47782426,39782426,horror
1178,18.06,8.1,12625,80000000,299461782,219461782,mystery
1179,20.468,7.3,4475,30000000,84393749,54393749,action
1180,29.725,6.7,1317,35000000,75885196,40885196,action
1181,0.657,7.3,2,200000,44701,-155299,crime
1182,10.617,7.1,1560,46500000,23726626,-22773374,drama
1183,7.079,5.2,184,2000000,16610760,14610760,drama
1184,15.350999999999999,7.1,7636,21000000,236412453,215412453,comedy
1185,0.64,0.0,1,1300000,1738663,438663,drama
1186,20.896,6.3,2210,65000000,40650842,-24349158,crime
1187,17.572,6.9,4303,75000000,634454789,559454789,animation
1188,13.117,6.8,2935,3000000,87727807,84727807,horror
1189,9.916,5.8,1142,10000000,54104225,44104225,horror
1190,10.993,5.9,922,30000000,106030660,76030660,biography
1191,9.362,5.6,96,9000000,1242,-8998758,documentary
1192,19.27,7.1,10441,200000000,1110526981,910526981,action
1193,8.847000000000001,4.8,833,10000000,68264973,58264973,action
1194,26.229,6.1,2177,125000000,304115534,179115534,action
1195,5.664,5.3,367,250000,3934450,3684450,action
1196,16.999000000000002,4.0,712,10000000,51723644,41723644,adventure
1197,5.3020000000000005,5.9,75,2000000,0,-2000000,comedy
1198,26.230999999999998,6.6,600,80000000,213691277,133691277,adventure
1199,15.663,6.2,736,60000000,197578586,137578586,adventure
1200,0.725,3.5,2,42000000,57852177,15852177,drama
1201,16.673,5.9,1493,15000000,57907734,42907734,action
1202,4.519,5.9,39,6000000,11348205,5348205,drama
1203,21.233,5.9,5258,170000000,401021746,231021746,action
1204,3.595,4.1,14,1000000,0,-1000000,horror
1205,13.703,7.1,2427,50000000,35380918,-14619082,biography
1206,14.735,6.8,4748,40000000,88069880,48069880,action
1207,29.502,6.6,3838,275000000,393151347,118151347,action
1208,5.9079999999999995,6.1,59,300000,0,-300000,comedy
1209,7.567,6.1,591,35000000,65084116,30084116,comedy
1210,2.403,4.5,21,3000000,0,-3000000,drama
1211,7.596,6.1,376,7000000,17023121,10023121,comedy
1212,8.289,6.4,123,22000000,70949793,48949793,biography
1213,6.206,5.6,126,6000000,437089,-5562911,drama
1214,15.887,6.9,481,3200000,18285560,15085560,comedy
1215,8.459,7.0,688,18000000,47158652,29158652,biography
1216,7.212000000000001,6.4,169,135000,429448,294448,drama
1217,13.495,7.2,4529,32000000,140428499,108428499,action
1218,25.305,7.4,3424,30000000,94156456,64156456,drama
1219,8.623,6.5,596,30000000,310985,-29689015,animation
1220,1.715,7.0,7,10000000,24660323,14660323,drama
1221,0.968,7.4,6,175000,2602,-172398,comedy
1222,2.443,3.6,19,150000,32927,-117073,horror
1223,30.318,6.4,6719,300000000,879620923,579620923,action
1224,0.6,5.3,3,1500000,7000000,5500000,mystery
1225,46.775,7.4,11585,175000000,880166350,705166350,action
1226,25.783,7.2,10375,5000000,278964806,273964806,comedy
1227,16.354,7.8,4935,20000000,92088460,72088460,drama
1228,10.690999999999999,5.0,2495,5000000,31149251,26149251,comedy
1229,16.379,7.1,1069,13000000,54837234,41837234,comedy
1230,8.799,6.2,415,4000000,679482,-3320518,drama
1231,1.224,4.3,12,5600000,531806,-5068194,musical
1232,19.142,6.7,4275,185000000,335802233,150802233,action
1233,20.487,7.4,6182,190000000,467381584,277381584,action
1234,0.6,6.0,3,60000000,88832210,28832210,documentary
1235,2.742,6.8,11,16000000,1686429,-14313571,western
1236,17.174,6.7,1160,30000000,165889117,135889117,drama
1237,10.925,6.8,1252,33000000,165552290,132552290,drama
1238,8.895,6.8,2572,30000000,35579007,5579007,biography
1239,10.747,7.5,1946,5000000,41699612,36699612,drama
1240,6.394,5.6,138,2000000,63555,-1936445,horror
1241,10.738,6.6,1282,12000000,12034913,34913,drama
1242,9.812999999999999,5.3,559,35000000,17967746,-17032254,action
1243,2.84,4.9,8,22000000,4065020,-17934980,crime
1244,5.209,6.2,69,2000000,304602,-1695398,drama
1245,12.100999999999999,6.5,1308,70000000,183353431,113353431,adventure
1246,5.307,5.3,71,2000000,0,-2000000,comedy
1247,11.731,7.7,2048,28000000,202182981,174182981,biography
1248,6.563,3.6,73,1900000,285593,-1614407,horror
1249,5.91,5.2,135,10000000,161097,-9838903,drama
1250,8.749,5.7,255,25000000,11253821,-13746179,action
1251,7.836,7.0,782,30000000,8786752,-21213248,biography
1252,1.2819999999999998,5.6,4,5000000,67505,-4932495,comedy
1253,6.5729999999999995,5.1,91,2500000,0,-2500000,action
1254,0.855,3.1,7,500000,0,-500000,horror
1255,7.412000000000001,7.4,770,1900000,4581937,2681937,comedy
1256,14.415999999999999,6.0,2716,75000000,89758389,14758389,action
1257,7.763,7.3,982,14000000,34044909,20044909,biography
1258,16.53,5.9,13533,175000000,746059887,571059887,action
1259,18.148,7.1,3924,60000000,238524556,178524556,biography
1260,11.36,6.6,726,2500000,593933,-1906067,action
1261,14.39,6.7,3934,50000000,257972745,207972745,mystery
1262,12.046,6.5,130,16000000,20723581,4723581,action
1263,0.6,7.0,2,14000000,30628981,16628981,comedy
1264,1.9069999999999998,6.7,13,60000,4917,-55083,comedy
1265,3.412,4.8,55,20000000,1703281,-18296719,action
1266,16.925,7.0,752,20000000,7034615,-12965385,fantasy
1267,5.232,5.1,44,8000000,44197,-7955803,action
1268,10.0,6.9,1789,3000000,5837111,2837111,adventure
1269,7.551,6.0,604,5000000,4620399,-379601,comedy
1270,1.4,4.0,1,28000000,77026186,49026186,action
1271,11.321,6.1,339,19000000,7576604,-11423396,comedy
1272,11.235999999999999,7.2,787,4750000,4972016,222016,drama
1273,16.078,6.2,4035,45000000,377807404,332807404,action
1274,27.679000000000002,6.1,3406,48000000,327656424,279656424,action
1275,8.969,6.2,605,32000000,70587268,38587268,action
1276,10.979000000000001,5.2,735,20000000,96407655,76407655,comedy
1277,21.511,7.5,6407,260000000,586477240,326477240,adventure
1278,7.727,5.5,348,145000000,448191819,303191819,adventure
1279,14.475,6.3,7727,50000000,556016627,506016627,comedy
1280,17.684,6.1,4227,68000000,217214143,149214143,comedy
1281,4.486000000000001,7.6,11,1500000,98806,-1401194,action
1282,16.523,7.0,304,10000000,51620593,41620593,action
1283,25.619,5.8,4259,13500000,202000000,188500000,action
1284,15.095999999999998,5.9,1860,135000000,245328374,110328374,action
1285,1.0,7.6,5,2000000,2350641,350641,documentary
1286,0.6,3.0,1,300000,0,-300000,action
1287,1.575,5.4,5,25000,0,-25000,drama
1288,0.6,8.0,1,250000,18823,-231177,drama
1289,9.251,7.4,486,10000000,6646669,-3353331,biography
1290,18.256,5.3,780,20000000,47666013,27666013,horror
1291,0.6,6.0,1,20000000,9985316,-10014684,biography
1292,8.649,6.1,1759,8000000,53068955,45068955,comedy
1293,12.817,5.5,831,57500000,58085235,585235,biography
1294,11.575999999999999,5.3,799,30000000,56096200,26096200,biography
1295,9.993,6.2,565,25000000,28400715,3400715,biography
1296,2.142,4.7,15,6000000,408159,-5591841,biography
1297,12.967,5.8,3657,38000000,111336398,73336398,action
1298,17.097,6.3,2703,110000000,177241171,67241171,action
1299,13.81,6.9,3407,40000000,152962083,112962083,action
1300,8.63,7.8,326,1000000,1227316,227316,crime
1301,13.717,6.6,2615,50200000,126931325,76731325,romance
1302,8.417,5.1,108,25000000,0,-25000000,adventure
1303,11.981,6.8,3251,130000000,373993951,243993951,action
1304,8.559,7.4,3853,30000000,68984536,38984536,drama
1305,0.9109999999999999,4.5,2,1300000,0,-1300000,action
1306,24.391,6.5,10411,220000000,757890267,537890267,action
1307,20.846999999999998,6.4,7220,200000000,708996336,508996336,action
1308,9.042,5.8,690,20000000,67950723,47950723,crime
1309,17.998,6.0,1851,73000000,352327887,279327887,action
1310,7.7139999999999995,4.3,221,17000000,10637281,-6362719,drama
1311,8.695,6.5,752,4000000,1989035,-2010965,drama
1312,10.155,7.4,1787,16000000,128256712,112256712,thriller
1313,50.288999999999994,7.6,19673,225000000,1517935897,1292935897,action
1314,10.73,6.4,782,4900000,6924321,2024321,thriller
1315,11.502,6.4,3528,2000000,7482387,5482387,drama
1316,15.49,6.0,806,35000000,75281179,40281179,comedy
1317,7.357,6.3,464,21000000,5046038,-15953962,drama
1318,10.133,6.1,757,5000000,11792942,6792942,horror
1319,8.665,6.9,756,10000000,134639780,124639780,comedy
1320,8.581,6.6,145,17000000,72835710,55835710,comedy
1321,8.622,7.3,1512,26000000,41059418,15059418,drama
1322,9.647,7.8,243,2100000,23600000,21500000,comedy
1323,20.08,6.2,1916,140000000,199646680,59646680,adventure
1324,14.327,7.3,4657,28000000,133162752,105162752,biography
1325,12.322000000000001,7.4,1302,5000000,53972860,48972860,comedy
1326,11.231,5.8,678,32500000,48425971,15925971,comedy
1327,7.077000000000001,5.8,393,41000000,7684524,-33315476,comedy
1328,8.152000000000001,6.5,328,110000,11000000,10890000,biography
1329,2.075,2.9,14,20000000,35841901,15841901,comedy
1330,18.985,6.7,3495,80000000,158750817,78750817,action
1331,11.392000000000001,7.4,1228,50000000,97651543,47651543,thriller
1332,9.033999999999999,7.5,2788,19000000,76086711,57086711,drama
1333,11.442,5.8,822,29000000,78652207,49652207,comedy
1334,7.445,6.4,4314,125000000,510878762,385878762,adventure
1335,2.494,6.1,31,3000000,421404,-2578596,comedy
1336,9.861,5.7,1627,45000000,135808837,90808837,action
1337,18.05,6.1,3630,125000000,280355920,155355920,action
1338,0.6,8.0,1,25000000,34356760,9356760,drama
1339,11.219000000000001,6.7,1016,60000000,111946251,51946251,adventure
1340,11.703,5.8,2223,10000000,68220952,58220952,horror
1341,0.6,5.7,6,4000000,53401938,49401938,horror
1342,6.495,6.0,240,900000,413733,-486267,comedy
1343,8.328,5.8,186,3500000,615816,-2884184,comedy
1344,9.847000000000001,5.1,678,7400000,31187727,23787727,drama
1345,15.335999999999999,6.5,4185,30000000,70689968,40689968,horror
1346,11.315,6.7,1779,12800000,69821476,57021476,thriller
1347,6.605,5.7,110,160000,32092,-127908,documentary
1348,10.265999999999998,5.7,982,95000000,104907746,9907746,comedy
1349,6.937,4.3,134,250000,62375,-187625,drama
1350,12.122,6.0,1406,52000000,75997067,23997067,comedy
1351,1.4,6.1,11,250000,0,-250000,drama
1352,1.4,6.0,15,7000000,1933829,-5066171,drama
1353,17.382,6.3,3196,155000000,418186950,263186950,adventure
1354,2.398,5.5,48,18000000,40651864,22651864,adventure
1355,8.974,5.1,463,20000000,25361206,5361206,action
1356,0.84,7.0,1,10000000,8890094,-1109906,action
1357,1.4,0.5,2,3000000,10473836,7473836,action
1358,7.433,5.6,68,15000000,1658706,-13341294,comedy
1359,20.063,6.2,2394,40000000,101985431,61985431,action
1360,18.886,7.5,5912,20000000,318000141,298000141,horror
1361,6.492999999999999,6.5,226,25000000,15907411,-9092589,comedy
1362,1.666,4.3,14,5000000,1504960,-3495040,mystery
1363,10.55,5.1,1072,25000000,71009334,46009334,crime
1364,2.733,4.4,14,20000000,38164784,18164784,horror
1365,12.245999999999999,6.2,1036,19000000,56445534,37445534,horror
1366,8.826,6.2,134,23000000,13019253,-9980747,documentary
1367,16.29,6.8,3873,135000000,573068425,438068425,action
1368,3.674,4.7,42,2000000,0,-2000000,drama
1369,0.6,6.0,2,3000000,772366,-2227634,comedy
1370,26.22,7.7,13933,275000000,1084439099,809439099,action
1371,15.517000000000001,5.6,2842,60000000,113461527,53461527,action
1372,10.73,4.9,735,34800000,62831715,28031715,documentary
1373,23.967,6.8,1158,34000000,38361428,4361428,action
1374,8.357000000000001,4.8,347,4000000,10898293,6898293,horror
1375,3.127,3.1,9,1100000,0,-1100000,action
1376,12.697000000000001,6.6,403,20000000,46604054,26604054,drama
1377,10.444,6.8,1522,20000000,175507800,155507800,drama
1378,7.403,4.7,441,1000000,101759490,100759490,horror
1379,7.505,6.7,291,19100000,5965646,-13134354,biography
1380,9.382,6.7,460,2000000,2279959,279959,comedy
1381,12.592,6.0,3042,65000000,180148897,115148897,comedy
1382,9.517999999999999,5.3,448,70000000,70546865,546865,comedy
1383,2.971,6.1,57,55000,0,-55000,crime
1384,6.324,4.4,272,15000000,3503761,-11496239,drama
1385,13.27,7.2,1895,10000000,28717667,18717667,biography
1386,1.5519999999999998,2.0,1,3000000,156362,-2843638,drama
1387,1.61,5.9,11,2000000,0,-2000000,drama
1388,14.795,6.7,1215,12600000,19054534,6454534,crime
1389,9.054,6.8,2987,8500000,43528634,35028634,comedy
1390,8.443,6.1,694,25000000,38993548,13993548,action
1391,8.044,6.6,438,6500000,3027956,-3472044,adventure
1392,11.546,7.2,2224,9000000,19096003,10096003,comedy
1393,14.88,5.4,1447,50000000,216562312,166562312,adventure
1394,28.941999999999997,7.2,4989,55000000,192903624,137903624,action
1395,22.961,6.4,2089,77000000,190453132,113453132,action
1396,21.517,6.1,4647,82000000,268268174,186268174,action
1397,17.215999999999998,6.2,4219,100000000,311979256,211979256,action
1398,18.797,6.1,2876,100000000,209461378,109461378,action
1399,5.056,5.9,46,7000000,492108,-6507892,comedy
1400,6.495,5.0,94,26000000,0,-26000000,crime
1401,5.519,6.1,68,4000000,1158877,-2841123,drama
1402,1.141,6.3,3,30000000,51078541,21078541,comedy
1403,28.668000000000003,6.9,6335,250000000,1234846267,984846267,action
1404,16.03,7.6,7236,12000000,307166834,295166834,drama
1405,28.651,7.7,2096,15000000,94113929,79113929,biography
1406,6.611000000000001,5.9,549,26000000,6154172,-19845828,biography
1407,10.395,7.3,2325,11000000,129262388,118262388,biography
1408,8.362,6.5,619,4500000,0,-4500000,comedy
1409,12.673,6.4,943,70000000,49252761,-20747239,action
1410,28.44,5.8,1846,13000000,136617305,123617305,action
1411,11.25,7.0,1426,2000000,17061,-1982939,comedy
1412,4.938,6.6,66,170000,169242,-758,drama
1413,10.729000000000001,5.8,742,30000000,61623819,31623819,comedy
1414,11.597000000000001,7.4,1125,2000000,11295324,9295324,drama
1415,14.616,6.7,1086,35000000,140783360,105783360,comedy
1416,1.125,2.5,1,10000000,40749230,30749230,documentary
1417,12.349,7.0,2093,15000000,24403192,9403192,comedy
1418,2.0069999999999997,5.4,16,60000,0,-60000,comedy
1419,1.9280000000000002,4.2,20,250000,0,-250000,drama
1420,10.34,6.3,762,19200000,5617460,-13582540,crime
1421,2.336,5.8,11,1000000,1239174,239174,drama
1422,9.166,4.8,591,100000,41656474,41556474,horror
1423,8.807,5.8,783,3000000,101773,-2898227,crime
1424,4.534,7.2,51,1500000,2592308,1092308,documentary
1425,2.971,6.5,9,2000000,2436,-1997564,comedy
1426,7.829,6.8,1135,45000000,65532491,20532491,drama
1427,5.945,6.3,70,900000,7396,-892604,comedy
1428,1.304,6.6,7,10000000,44567606,34567606,animation
1429,1.595,5.9,25,45000000,174278214,129278214,crime
1430,13.714,6.4,982,5250000,4801837,-448163,drama
1431,17.823,7.3,3971,90000000,239373970,149373970,crime
1432,8.687000000000001,6.5,3075,25000000,66540205,41540205,drama
1433,17.675,6.7,3135,187500000,333771037,146271037,adventure
1434,0.6,5.4,5,11000000,4234355,-6765645,drama
1435,2.142,6.5,18,200000,2430735,2230735,drama
1436,18.31,8.0,8091,31000000,163981261,132981261,adventure
1437,15.397,7.4,7120,7000000,26533200,19533200,drama
1438,19.144000000000002,5.8,2775,150000000,334486852,184486852,documentary
1439,22.009,8.0,5197,84000000,386665550,302665550,biography
1440,14.501,5.5,1897,110000000,229155503,119155503,action
1441,13.67,5.2,619,1000000,12931420,11931420,adventure
1442,12.942,6.5,2280,25000000,81249176,56249176,action
1443,10.177,6.9,563,6000000,21197454,15197454,comedy
1444,0.84,5.3,2,70000000,94973540,24973540,action
1445,8.939,5.4,403,40000000,41294674,1294674,comedy
1446,10.388,5.7,583,40000000,18594227,-21405773,action
1447,1.9609999999999999,6.5,16,850000,442638,-407362,biography
1448,32.266,6.4,6231,80000000,586464305,506464305,comedy
1449,19.135,8.2,636,23000000,35067665,12067665,crime
1450,20.680999999999997,7.7,8065,62000000,147864886,85864886,crime
1451,16.912,6.6,2441,43000000,229727774,186727774,action
1452,12.597999999999999,8.1,3944,25000000,213120004,188120004,drama
1453,6.2410000000000005,5.4,116,6000000,0,-6000000,action
1454,26.939,7.2,12076,250000000,1017003568,767003568,adventure
1455,53.783,7.3,8392,250000000,945577621,695577621,adventure
1456,21.275,7.6,7739,250000000,960366855,710366855,adventure
1457,8.232000000000001,6.5,389,16000000,8217571,-7782429,drama
1458,11.458,6.2,2788,50000000,64477051,14477051,action
1459,9.62,5.7,474,40000000,31192425,-8807575,comedy
1460,21.805,6.2,933,40000000,126331750,86331750,comedy
1461,8.26,7.3,785,22000000,94270488,72270488,comedy
1462,14.212,7.1,14587,80000000,677923379,597923379,action
1463,20.187,7.4,11170,130000000,864868047,734868047,action
1464,33.836999999999996,6.8,10087,125000000,766575131,641575131,action
1465,19.487000000000002,6.8,7609,160000000,648986787,488986787,action
1466,2.897,5.2,10,55000000,47213095,-7786905,action
1467,13.335,5.4,476,40000000,30963684,-9036316,action
1468,11.248,6.5,562,10000000,3623609,-6376391,biography
1469,10.127,6.7,1405,23000000,77735925,54735925,drama
1470,8.404,7.4,280,16500000,83792062,67292062,documentary
1471,1.3130000000000002,6.3,4,50000,0,-50000,biography
1472,33.078,8.1,10396,15000000,227740463,212740463,biography
1473,8.145,6.2,438,16000000,7585011,-8414989,drama
1474,14.66,7.2,3614,40000000,169590606,129590606,drama
1475,9.362,5.4,920,32000000,27392609,-4607391,adventure
1476,9.588,6.6,943,47500000,20718104,-26781896,biography
1477,8.494,5.5,324,750000,1011535,261535,drama
1478,14.377,7.1,3373,40000000,197115710,157115710,comedy
1479,0.6,6.2,2631,58000000,93672764,35672764,comedy
1480,15.501,6.2,3579,44000000,12342632,-31657368,documentary
1481,10.424000000000001,6.5,1063,1000000,354836,-645164,documentary
1482,8.987,6.4,899,14000000,115592104,101592104,biography
1483,6.4239999999999995,6.2,312,10000000,3541565,-6458435,comedy
1484,1.893,6.7,20,500000,19800,-480200,documentary
1485,16.464000000000002,7.3,2356,50000000,76119388,26119388,crime
1486,20.129,6.8,5257,27000000,44342956,17342956,animation
1487,12.255999999999998,6.3,3140,40000000,351774938,311774938,action
1488,2.403,6.9,12,65000000,69688384,4688384,drama
1489,8.426,6.6,854,4000000,36275469,32275469,comedy
1490,7.087000000000001,5.9,304,13000000,3617277,-9382723,crime
1491,9.269,6.3,393,6000000,42320503,36320503,biography
1492,16.595,4.6,2143,150000000,319713881,169713881,action
1493,8.759,5.3,407,10600000,261364,-10338636,adventure
1494,9.35,5.6,519,1800000,70165900,68365900,drama
1495,7.561,4.5,297,4000000,25448707,21448707,drama
1496,5.079,5.9,230,2000000,205298,-1794702,comedy
1497,1.4,4.9,9,13400000,164247,-13235753,comedy
1498,9.237,7.2,2199,20000000,92678948,72678948,drama
1499,15.894,5.9,1692,30000000,48330757,18330757,action
1500,16.685,5.8,2193,80000000,130818912,50818912,action
1501,10.157,5.1,825,5000000,38359310,33359310,horror
1502,13.754000000000001,4.5,805,70000000,58953319,-11046681,action
1503,14.797,5.8,4102,180000000,348902025,168902025,action
1504,19.352,7.2,2882,80000000,310660018,230660018,action
1505,19.375,7.4,4839,60000000,457729388,397729388,action
1506,14.607000000000001,6.3,424,70000000,122737201,52737201,action
1507,29.886999999999997,7.1,831,20000000,22281732,2281732,drama
1508,11.812000000000001,7.1,1525,40000000,87145086,47145086,crime
1509,28.583000000000002,8.2,10160,79300000,986214868,906914868,adventure
1510,1.4,4.5,3,1500000,0,-1500000,biography
1511,8.512,7.6,1493,77500000,102028919,24528919,adventure
1512,15.64,6.9,2895,4500000,18019834,13519834,comedy
1513,12.482000000000001,6.0,3789,275000000,260002115,-14997885,action
1514,11.168,7.5,1908,34000000,63802928,29802928,drama
1515,0.6,5.0,1,300000,1711,-298289,fantasy
1516,8.434,5.3,445,1500000,1541131,41131,horror
1517,10.202,6.2,844,25000000,29863840,4863840,action
1518,11.048,6.2,1397,30000000,17121823,-12878177,adventure
1519,2.164,5.5,21,2500000,549632,-1950368,adventure
1520,0.6,5.0,2,15000000,9010980,-5989020,adventure
1521,5.232,4.7,47,35000000,53899,-34946101,action
1522,13.14,6.9,2012,25000000,96633833,71633833,drama
1523,5.888,7.3,350,1700000,12231500,10531500,drama
1524,0.647,9.0,2,27000000,0,-27000000,music
1525,18.487000000000002,6.2,3647,90000000,162525156,72525156,action
1526,0.8490000000000001,4.8,6,600000,0,-600000,thriller
1527,18.956,7.1,3525,75000000,104949584,29949584,action
1528,8.76,7.2,699,10000000,12382122,2382122,biography
1529,15.457,5.3,573,15000000,22018988,7018988,action
1530,22.855999999999998,7.7,12172,108000000,655271443,547271443,adventure
1531,1.42,3.5,16,3500000,182695,-3317305,action
1532,12.829,7.1,1323,37500000,50647416,13147416,action
1533,36.955,7.1,10626,34000000,348319861,314319861,action
1534,14.387,6.3,1676,42500000,76347393,33847393,action
1535,7.725,5.8,186,3200000,5526942,2326942,comedy
1536,31.397,5.9,2896,178000000,529530715,351530715,action
1537,0.6,8.0,2,6500000,1744952,-4755048,drama
1538,12.860999999999999,5.9,2229,70000000,158702748,88702748,comedy
1539,16.484,6.3,2915,60000000,75965567,15965567,action
1540,6.1610000000000005,6.4,77,50000000,170857676,120857676,crime
1541,18.53,5.5,4391,195000000,409953905,214953905,action
1542,11.324000000000002,6.6,831,45000000,160971922,115971922,adventure
1543,11.787,6.6,2005,7500000,3559803,-3940197,horror
1544,11.147,7.0,1469,30000000,67255916,37255916,action
1545,13.743,7.1,4272,50000000,59596747,9596747,action
1546,9.014,6.1,956,25000000,52427346,27427346,documentary
1547,0.6709999999999999,4.5,2,100000,0,-100000,horror
1548,17.747,6.1,852,15000000,34820335,19820335,action
1549,10.501,5.6,529,30000000,122529966,92529966,adventure
1550,8.975,5.7,227,40000000,57438389,17438389,adventure
1551,26.235,6.0,909,132900000,170293899,37393899,adventure
1552,7.566,5.5,97,90000000,20466016,-69533984,action
1553,9.216000000000001,6.7,605,40000000,55249159,15249159,comedy
1554,1.29,5.6,5,49000000,72689126,23689126,comedy
1555,1.578,2.6,9,20000000,1065907,-18934093,adventure
1556,8.832,4.1,20,3300000,50206,-3249794,comedy
1557,1.304,7.5,12,500000,314444,-185556,documentary
1558,13.508,6.2,2187,100000000,170936470,70936470,action
1559,9.078,5.3,470,5000000,12905107,7905107,drama
1560,6.359,4.9,60,40000000,195111193,155111193,comedy
1561,0.628,6.0,1,500000,0,-500000,documentary
1562,6.5760000000000005,6.0,200,200000,1165996,965996,comedy
1563,8.142999999999999,5.5,409,12500000,4027663,-8472337,crime
1564,0.6,5.5,2,100000,20056,-79944,biography
1565,11.344000000000001,6.6,894,99000000,250091610,151091610,adventure
1566,6.727,5.7,211,18000000,60278166,42278166,crime
1567,6.087999999999999,6.3,217,1000000,51587,-948413,fantasy
1568,0.655,8.0,2,10000000,19535005,9535005,drama
1569,6.875,5.5,78,5000000,10182050,5182050,romance
1570,15.148,7.8,5938,13000000,33069303,20069303,drama
1571,12.96,6.9,2781,15000000,47011449,32011449,crime
1572,0.6,6.0,1,45000000,29406132,-15593868,drama
1573,8.978,5.9,918,14000000,82925064,68925064,horror
1574,20.262999999999998,5.1,393,6000000,42785387,36785387,horror
1575,15.550999999999998,7.0,2506,50000000,179748880,129748880,biography
1576,29.473000000000003,5.2,2018,88000000,159487563,71487563,action
1577,12.324000000000002,4.8,317,18000000,0,-18000000,action
1578,0.6,9.0,1,90000000,10551417,-79448583,drama
1579,24.364,6.2,4797,3000000,91266581,88266581,horror
1580,28.424,6.6,3754,9000000,111534881,102534881,action
1581,18.975,6.3,2900,10000000,118514727,108514727,action
1582,9.582,6.9,408,18000000,23910210,5910210,biography
1583,0.6,5.9,5,26000000,30601801,4601801,crime
1584,5.172999999999999,5.6,264,10000000,15037867,5037867,adventure
1585,7.46,6.7,120,15000000,528731,-14471269,drama
1586,1.5090000000000001,6.7,10,2000000,2303792,303792,comedy
1587,0.6,7.0,2,15000000,5953886,-9046114,documentary
1588,19.41,7.4,11064,135000000,532938302,397938302,action
1589,10.187000000000001,5.0,676,60000000,0,-60000000,comedy
1590,3.322,4.8,26,2500000,0,-2500000,crime
1591,9.676,5.9,994,37000000,97143987,60143987,drama
1592,2.948,5.1,24,25000000,29206732,4206732,adventure
1593,8.134,5.4,406,16000000,52545707,36545707,drama
1594,13.527999999999999,6.2,435,8500000,3180252,-5319748,action
1595,12.011,5.7,652,45000000,21544732,-23455268,comedy
1596,8.19,6.4,448,9500000,5278632,-4221368,biography
1597,6.957999999999999,5.1,133,90000000,169400000,79400000,drama
1598,6.16,6.7,97,9000000,20395040,11395040,biography
1599,7.731,6.4,420,10000000,90384306,80384306,comedy
1600,9.908999999999999,6.1,5374,75000000,886750534,811750534,adventure
1601,10.743,7.1,4859,91000000,187861183,96861183,adventure
1602,6.46,6.9,296,1000000,11495204,10495204,biography
1603,14.091,6.3,3037,13000000,118763442,105763442,drama
1604,22.025,7.2,7224,19500000,195790794,176290794,adventure
1605,0.6609999999999999,7.0,2,50000,406299,356299,drama
1606,3.3139999999999996,6.4,51,1000000,6870,-993130,drama
1607,13.738,7.0,590,38000000,13143056,-24856944,adventure
1608,11.571,5.4,472,25000000,38749404,13749404,comedy
1609,10.341,6.7,394,1000000,5797192,4797192,comedy
1610,2.659,4.1,9,1100000,2636,-1097364,drama
1611,16.533,5.6,2112,110000000,563749323,453749323,adventure
1612,12.940999999999999,5.7,1200,110000000,348547523,238547523,adventure
1613,14.581,5.1,1225,35000000,43226146,8226146,crime
1614,15.889000000000001,7.2,6116,40000000,224922135,184922135,biography
1615,7.586,5.1,156,15000000,1148578,-13851422,action
1616,14.463,5.9,2879,160000000,217986320,57986320,action
1617,14.437000000000001,7.1,1455,30000000,16481405,-13518595,adventure
1618,13.679,6.6,1801,2500000,6916951,4416951,comedy
1619,13.815,5.7,1165,74000000,311013181,237013181,adventure
1620,10.745999999999999,5.7,650,28000000,46752858,18752858,action
1621,9.396,6.9,606,1500000,176262,-1323738,documentary
1622,14.53,5.4,233,20000000,62758010,42758010,adventure
1623,13.31,5.4,621,5000000,29960051,24960051,horror
1624,6.4,5.9,142,4500000,8000366,3500366,action
1625,7.745,6.1,1008,19000000,49858465,30858465,comedy
1626,6.3,5.8,52,20000000,277943,-19722057,comedy
1627,13.866,7.9,6412,15000000,123327692,108327692,biography
1628,12.349,6.1,1404,38000000,27573078,-10426922,horror
1629,11.932,5.7,1596,90000000,139877913,49877913,action
1630,9.357999999999999,5.1,215,30000000,54052249,24052249,documentary
1631,7.33,5.5,534,1500000,4128828,2628828,comedy
1632,10.307,6.1,3133,100000000,278731369,178731369,action
1633,13.475999999999999,7.1,2386,37000000,152566881,115566881,horror
1634,13.427999999999999,5.4,836,22000000,69698495,47698495,action
1635,11.569,6.6,1730,35000000,61721826,26721826,drama
1636,20.34,6.0,4909,68000000,706102828,638102828,adventure
1637,28.138,7.3,274,37500000,119024536,81524536,comedy
1638,0.8190000000000001,4.2,14,1100000,0,-1100000,horror
1639,7.841,4.6,365,13000000,14929184,1929184,horror
1640,6.0,4.1,44,4000000,0,-4000000,horror
1641,4.834,4.6,35,2000000,636706,-1363294,comedy
1642,0.631,8.0,1,5000000,98677816,93677816,comedy
1643,13.046,7.1,2409,30000000,197618160,167618160,drama
1644,11.754000000000001,6.9,1906,35000000,61492104,26492104,adventure
1645,3.215,5.0,59,2000000,0,-2000000,comedy
1646,5.577000000000001,6.7,61,3000000,4495262,1495262,comedy
1647,8.259,6.1,203,42000000,8514325,-33485675,action
1648,10.228,5.4,1356,55000000,67130045,12130045,action
1649,2.237,5.4,58,33000000,47267829,14267829,drama
1650,11.479000000000001,6.8,682,22500000,31054727,8554727,drama
1651,9.977,7.1,1043,5000000,26853810,21853810,comedy
1652,15.876,6.5,961,23000000,80171596,57171596,comedy
1653,2.897,4.4,28,1200000,0,-1200000,horror
1654,13.493,6.6,2931,3500000,40454520,36954520,horror
1655,29.518,7.9,12411,100000000,389870414,289870414,biography
1656,14.03,5.7,1009,150000000,142634358,-7365642,drama
1657,4.323,6.3,6176,115000000,416456852,301456852,action
1658,12.780999999999999,6.1,2122,15000000,128955898,113955898,drama
1659,0.84,4.8,15,200000,3648,-196352,drama
1660,7.2010000000000005,6.6,628,6000000,16369708,10369708,drama
1661,12.719000000000001,6.7,2990,20000000,47508505,27508505,action
1662,7.285,6.7,389,33000000,357687,-32642313,action
1663,5.531000000000001,6.1,50,16800000,7313697,-9486303,drama
1664,7.058,5.1,93,36000000,4020990,-31979010,biography
1665,7.353,5.5,226,3000000,82780,-2917220,comedy
1666,0.6,5.0,1,600000,7943,-592057,documentary
1667,5.905,6.9,438,12000000,113373764,101373764,comedy
1668,8.25,6.3,319,24000000,70027933,46027933,comedy
1669,8.132,5.7,1296,35000000,90221182,55221182,comedy
1670,1.8969999999999998,5.7,9,42000,0,-42000,drama
1671,10.635,6.2,3789,32000000,126539117,94539117,comedy
1672,9.681000000000001,6.6,695,20000000,41296320,21296320,comedy
1673,12.017000000000001,6.0,2096,65000000,156974557,91974557,action
1674,38.068000000000005,6.7,12764,150000000,449326618,299326618,action
1675,43.45,7.5,11380,180000000,846980024,666980024,action
1676,31.014,6.7,10171,150000000,644602516,494602516,action
1677,11.241,6.3,398,5000000,3187302,-1812698,comedy
1678,17.808,8.2,5432,12000000,160191915,148191915,crime
1679,6.781000000000001,6.3,196,34000000,62582520,28582520,adventure
1680,2.62,6.2,8,100000,0,-100000,drama
1681,4.946000000000001,5.7,61,3000000,223652,-2776348,comedy
1682,0.753,8.3,3,3500000,29233,-3470767,documentary
1683,10.831,6.7,1402,21000000,81452811,60452811,drama
1684,6.695,5.9,82,50000,424149,374149,comedy
1685,9.562999999999999,5.7,1097,21500000,74326015,52826015,comedy
1686,6.327999999999999,6.8,66,3400000,0,-3400000,biography
1687,24.968000000000004,6.3,4310,90000000,273477501,183477501,action
1688,20.136,6.2,4610,170000000,206627518,36627518,action
1689,12.65,5.3,1058,48000000,112610386,64610386,comedy
1690,6.322,6.3,281,12000000,26001741,14001741,comedy
1691,1.249,6.9,10,150000,5858,-144142,documentary
1692,17.243,5.9,3486,125000000,211856088,86856088,action
1693,12.213,6.0,1592,85000000,150422946,65422946,action
1694,24.445,7.7,8340,200000000,1068879522,868879522,adventure
1695,3.5810000000000004,6.7,29,6500000,3149,-6496851,action
1696,5.882000000000001,5.7,16,5800000,15091,-5784909,drama
1697,18.423,5.8,1731,35000000,141123897,106123897,comedy
1698,9.571,6.6,1348,16000000,22594052,6594052,documentary
1699,11.035,6.0,3491,100000000,103039258,3039258,action
1700,20.961,5.8,4805,210000000,1104039076,894039076,action
1701,5.3389999999999995,6.1,4961,195000000,1123790543,928790543,action
1702,24.258000000000003,6.0,3255,217000000,602893340,385893340,action
1703,0.655,5.8,2,30000000,6916869,-23083131,thriller
1704,0.6,3.0,3,12000000,6553186,-5446814,comedy
1705,1.874,4.8,5,625000,0,-625000,drama
1706,1.39,6.2,7,4700000,0,-4700000,comedy
1707,11.909,5.5,589,35000000,786532,-34213468,crime
1708,7.761,6.8,1094,12000000,1594955,-10405045,family
1709,13.334000000000001,5.8,1258,20000000,25943792,5943792,crime
1710,16.285999999999998,6.6,1880,125000000,344150134,219150134,adventure
1711,13.459000000000001,6.3,4387,200000000,400062763,200062763,action
1712,8.548,6.7,613,60000000,47818913,-12181087,drama
1713,13.118,7.2,2816,35000000,252276928,217276928,adventure
1714,7.805,6.6,556,4000000,120016,-3879984,drama
1715,0.6,7.0,1,3500000,95127344,91627344,comedy
1716,9.89,6.4,307,25000000,6792768,-18207232,drama
1717,14.876,6.1,1758,135000000,286896578,151896578,adventure
1718,1.073,5.6,5,55000000,11532774,-43467226,action
1719,8.655,5.3,601,3000000,1887554,-1112446,comedy
1720,6.12,5.0,132,7000000,1268346,-5731654,comedy
1721,9.191,6.5,1241,1600000,868081,-731919,comedy
1722,12.354000000000001,7.4,2240,65000000,163527824,98527824,biography
1723,10.835999999999999,6.5,220,18000000,46527161,28527161,comedy
1724,3.705,5.5,42,20000000,18826490,-1173510,comedy
1725,9.527000000000001,6.1,1781,13300000,7229933,-6070067,drama
1726,1.4,5.5,16,2500000,1392649,-1107351,documentary
1727,18.976,5.5,2318,35000000,81209222,46209222,action
1728,8.516,5.2,472,35000000,13214051,-21785949,fantasy
1729,8.323,5.5,310,12000000,16221211,4221211,drama
1730,8.12,5.4,2019,1000000,64364198,63364198,horror
1731,17.861,6.1,365,1000000,16434588,15434588,crime
1732,3.864,5.1,6,29000000,0,-29000000,thriller
1733,1.5190000000000001,3.3,21,30000000,168832,-29831168,drama
1734,12.08,6.6,2043,40000000,136123083,96123083,action
1735,4.652,4.3,22,3000000,0,-3000000,action
1736,16.316,6.2,667,1500000,14244931,12744931,drama
1737,14.01,6.4,1913,95000000,165720921,70720921,documentary
1738,2.478,3.3,3,1500000,510957,-989043,action
1739,21.413,7.4,1326,3000000,16553285,13553285,drama
1740,12.454,6.2,1645,50000000,26387039,-23612961,drama
1741,11.220999999999998,5.9,328,40000000,1663785,-38336215,action
1742,0.6,7.0,1,31000000,102306500,71306500,adventure
1743,11.187000000000001,5.8,1907,52000000,217569328,165569328,comedy
1744,24.003,6.6,4149,180000000,215098356,35098356,action
1745,2.989,6.0,12,20000000,20268825,268825,comedy
1746,8.992,4.1,658,20000000,81424988,61424988,comedy
1747,6.65,5.0,145,16000000,94812,-15905188,comedy
1748,44.007,6.6,6206,25000000,881745,-24118255,thriller
1749,7.821000000000001,6.7,699,6000000,3485383,-2514617,crime
1750,1.266,6.3,13,800000,0,-800000,drama
1751,14.640999999999998,4.3,312,60000000,70883171,10883171,action
1752,9.061,5.8,1200,40000000,31124367,-8875633,drama
1753,3.2769999999999997,5.5,31,700000,0,-700000,thriller
1754,9.896,5.4,693,32500000,24159934,-8340066,comedy
1755,0.6,6.0,1,25000000,40686409,15686409,drama
1756,10.654000000000002,6.8,2387,50000000,86234503,36234503,comedy
1757,23.445,7.0,5235,152000000,489592267,337592267,action
1758,10.378,7.2,1849,70000000,156815529,86815529,drama
1759,0.6,7.1,5,132000000,606836535,474836535,thriller
1760,7.419,7.5,171,3000000,73975239,70975239,drama
1761,21.464000000000002,6.3,4071,160000000,425522281,265522281,action
1762,13.259,6.3,4109,30000000,115121608,85121608,comedy
1763,15.478,7.8,2189,25000000,24215385,-784615,drama
1764,0.628,3.0,1,600000,42557,-557443,crime
1765,6.209,6.9,1627,38000000,116809717,78809717,drama
1766,10.809000000000001,6.3,1241,2000000,10153415,8153415,drama
1767,9.931000000000001,6.7,1523,50000000,118729073,68729073,comedy
1768,11.964,7.6,1306,7000000,10765283,3765283,drama
1769,14.745999999999999,6.8,5231,37000000,267816276,230816276,comedy
1770,8.326,7.5,287,190000,1577585,1387585,horror
1771,22.031999999999996,6.6,286,45000000,12874922,-32125078,biography
1772,8.347999999999999,6.5,241,10000000,355919,-9644081,drama
1773,12.27,5.9,1130,37500000,88473016,50973016,comedy
1774,1.9169999999999998,6.6,13,65000000,374105123,309105123,comedy
1775,10.390999999999998,6.4,1271,20000000,30163785,10163785,comedy
1776,8.062000000000001,5.3,150,10000000,30768449,20768449,crime
1777,6.08,6.6,185,15000000,30138912,15138912,drama
1778,8.022,5.9,609,10000000,17503828,7503828,comedy
1779,28.784000000000002,8.4,7908,3300000,38969037,35669037,drama
1780,8.564,6.2,596,35000000,25350747,-9649253,biography
1781,13.794,6.3,277,30000000,25947983,-4052017,crime
1782,15.879000000000001,7.2,69,14000000,34729091,20729091,adventure
1783,13.026,6.4,2817,150000000,205440387,55440387,action
1784,6.636,5.9,49,20000000,60831067,40831067,comedy
1785,15.044,6.2,2494,38000000,117425156,79425156,comedy
1786,20.628,6.5,941,40000000,73866088,33866088,comedy
1787,10.097999999999999,7.0,1454,15000000,52460543,37460543,adventure
1788,0.917,8.0,1,30000000,4315789,-25684211,action
1789,9.355,6.4,356,8000000,5314194,-2685806,action
1790,6.97,5.8,195,5200000,2000000,-3200000,documentary
1791,12.44,5.7,884,3500000,44378040,40878040,biography
1792,1.3880000000000001,6.0,8,2000000,0,-2000000,action
1793,1.608,2.5,4,850000,3256,-846744,mystery
1794,3.2119999999999997,3.8,12,2000000,0,-2000000,adventure
1795,1.88,5.7,6,15000000,61847,-14938153,biography
1796,11.147,6.9,444,30000000,50145607,20145607,adventure
1797,9.824,6.9,931,2000000,16131551,14131551,drama
1798,7.845,6.6,440,6000000,6591365,591365,comedy
1799,10.219,5.4,690,12000000,23477345,11477345,drama
1800,2.312,4.5,13,4700000,0,-4700000,comedy
1801,0.6,7.0,2,70000000,131011757,61011757,drama
1802,8.627,5.8,151,18000000,94953,-17905047,action
1803,7.76,7.4,787,11000000,58586407,47586407,biography
1804,8.482999999999999,6.1,159,13000000,0,-13000000,drama
1805,0.938,6.2,3,19000000,5745503,-13254497,sport
1806,20.101,8.2,3959,20000000,304604712,284604712,drama
1807,31.618000000000002,7.3,12566,150000000,821133378,671133378,action
1808,0.6,3.3,3,5500000,1060512,-4439488,comedy
1809,5.575,7.0,79,13000000,14403703,1403703,drama
1810,14.582,6.7,9132,190000000,531514650,341514650,action
1811,14.991,5.6,2442,150000000,305270083,155270083,action
1812,22.967,7.3,7780,165000000,496511521,331511521,adventure
1813,7.61,6.1,115,8000000,2721534,-5278466,drama
1814,39.293,6.5,8348,178000000,542537546,364537546,action
1815,41.867,7.5,10062,200000000,747862775,547862775,action
1816,1.4469999999999998,7.2,8211,160000000,355408305,195408305,action
1817,21.749000000000002,5.6,2452,85000000,345033359,260033359,action
1818,8.05,4.5,221,5000000,22958,-4977042,action
1819,9.096,5.3,387,80000000,204774690,124774690,adventure
1820,10.208,6.2,734,20000000,32838945,12838945,comedy
1821,6.209,5.8,431,15000000,34247816,19247816,comedy
1822,11.45,6.6,1258,1000000,26887177,25887177,action
1823,8.335,5.7,603,12000000,22750356,10750356,comedy
1824,0.6,3.0,4,50000000,26121638,-23878362,adventure
1825,7.115,6.6,192,120000,3090593,2970593,comedy
1826,1.008,5.3,9,13000000,24001573,11001573,drama
1827,7.931,5.6,131,20000000,34454336,14454336,adventure
1828,14.239,6.9,2553,52500000,134612435,82112435,drama
1829,9.373,5.7,85,4500000,0,-4500000,drama
1830,10.764000000000001,5.3,886,80000000,170805525,90805525,comedy
1831,12.997,4.7,1374,50000000,55348693,5348693,comedy
1832,3.4339999999999997,5.5,43,35000000,12506188,-22493812,comedy
1833,27.549,7.7,9977,150000000,1019429616,869429616,adventure
